after how many years are the olympic games held?	["Once every two years"]
how deep is lake merritt oakland?	["Oakland"]
how large is kony army?	["Kony 2012: Part II - Beyond Famous"]
how many kids were there in the kennedy family?	["Robert F. Kennedy","Ted Kennedy","Rosemary Kennedy","Kathleen Cavendish","Patricia Kennedy Lawford","Jean Kennedy Smith","Eunice Kennedy Shriver","Joseph P. Kennedy, Jr."]
how many languages do they speak in spain?	["Basque Language","Galician Language","Catalan language","Occitan language"]
how many languages do they speak in switzerland?	["Romansh language","French Language","German Language","Italian Language"]
how many mary mary sisters?	["Erica Campbell","Tina Campbell"]
how old is bruno mars and where is he from?	["Honolulu"]
in what country do people speak danish?	["Denmark","Greenland"]
in which continent is germany?	["Europe"]
in which state was the battle of antietam fought?	["9/17/1862"]
through which countries of the sahel does the niger river flow?	["Guinea","Niger","Mali","Nigeria","Benin"]
under what political system does the united states government operate?	["Presidential system","Federal republic","Representative democracy","Two-party system","Constitutional republic","Republic"]
what 3 states border florida?	["Alabama","Georgia"]
what 5 countries border switzerland?	["Trentino-Alto Adige/South Tyrol","Italy","Austria","France","Liechtenstein","Germany","Haut-Rhin"]
what activities are there to do in greece?	["Ionian Islands"]
what age did william penn get married?	["william penn not favored by william of orange"]
what airport do you fly into in paris?	["Gare du Nord","Paris Orly Airport","Gare de Paris-Est","Paris-Gare de Lyon","Gare Saint-Lazare","Gare Routière Internationale","Charles de Gaulle Airport","Aeroport de Paris Beauvais Tille","Gare d'Austerlitz","Gare Montparnasse"]
what airport do you fly into to get to destin fl?	["Northwest Florida Regional Airport","Destin–Fort Walton Beach Airport"]
what airport is near arlington tx?	["Arlington Municipal Airport"]
what airport is nearest to rome?	["Ciampino – G.B. Pastine International Airport"]
what all did ben franklin invent?	["Lightning rod","Franklin stove","Bifocals","Glass harmonica"]
what all does google now do?	["Google Maps","Nexus 7","Google Buzz","Nexus 10","Nexus One","Nexus S","Google Chrome","Google Earth","Google Wave"]
what all movies has taylor lautner been in?	["New Moon","He's a Bully, Charlie Brown","Eclipse","Cheaper by the Dozen 2","Incarceron","The Adventures of Sharkboy and Lavagirl","Dear Eleanor","Abduction","Shadow Fury","Field of Dreams 2: Lockout"]
what animal represents california?	["California grizzly bear"]
what are abraham sons names?	["Zimran","Ishbak","Midian","Shuah","Ishmael","Jokshan","Isaac","Medan"]
what are all the countries in north africa?	["Sus al-Aksa","Rashidun Caliphate","Ptolemaic Egypt","Western Roman Empire","Maghreb","Sudan","Ancient Greece","Ptolemaic Kingdom","Roman Republic","Roman Empire"]
what are all the movies taylor swift has been in?	["Hannah Montana: The Movie","Campfire Stories;Comes Around Gos Around","The Lorax","Valentine's Day"]
what are all the names of the harry potter books?	["Harry Potter and the Half-Blood Prince","Harry Potter and the Deathly Hallows","Harry Potter and the Goblet of Fire","Harry Potter and the Philosopher's Stone","Harry Potter and the Chamber of Secrets","Harry Potter and the Order of the Phoenix","Harry Potter and the Prisoner of Azkaban"]
what are all the songs justin bieber wrote?	["Catching Feelings","Down to Earth","Beauty and a Beat","All Around The World (featuring Ludacris)","Die in Your Arms","As Long As You Love Me (featuring Big Sean)","Baby","Believe","Be Alright","Boyfriend"]
what area of science did leonardo da vinci study?	["Writer","Military Engineer","Musician","Anatomist","Architect","Botanist","Civil engineer","Inventor","Painter","Engineer"]
what area of science did sir isaac newton study?	["Mathematics","Algebra"]
what are aristotle's contributions to science?	["Politics","Ethics","Aesthetics","Metaphysics"]
what are bigos?	["Stew"]
what are dallas cowboys colors?	["Blue","Royal blue","White","Silver","Navy Blue"]
what are egyptian money called?	["Egyptian pound"]
what are fun things to do in sacramento ca?	["Sacramento Zoo"]
what are italians classified as?	["Latin European peoples","Europeans"]
what are john terry's children called?	["Georgie John Terry","Summer Rose Terry"]
what are malaysian coins called?	["Malaysian ringgit"]
what are members of the house of representatives called?	["Representative"]
what are physical features of egypt?	["Sahara","Libyan Desert"]
what are republicans views on health care?	["20003"]
what are serena williams achievements?	["2010 Australian Open","2012 Wimbledon Championships","2012 US Open","2010 Mutua Madrileña Madrid Open","2011 Rogers Cup","2010 Wimbledon Championships","2009 Australian Open","2010 French Open"]
what are some ancient egypt names?	["Abdel Hakim Amer","Abdul Munim Riad","Ahmad Ismail Ali","Abdul Munim Wassel","Saad El Shazly","Hosni Mubarak","Mohammed Aly Fahmy","Anwar Sadat","Abd-Al-Minaam Khaleel","Abdel Ghani el-Gamasy"]
what are some books that mark twain wrote?	["Tom Sawyer Abroad","Mark Twain's (Burlesque) Autobiography and First Romance","A Connecticut Yankee in King Arthur's Court","Pudd'nhead Wilson","Autobiography of Mark Twain","Tom Sawyer, Detective","The Adventures of Tom Sawyer","Personal Recollections of Joan of Arc","The Prince and the Pauper","Adventures of Huckleberry Finn"]
what are some famous people from el salvador?	["William Torres Alegria","Ana Sol Gutierrez","Julio Enrique Martínez","Andrés Eduardo Menéndez","Erwin Raphael McManus","Willian Renderos Iraheta","Óscar Navarro","Ruben Cedillos","Roberto Carlos Martinez","Raul Antonio Garcia"]
what are some good books like looking for alaska?	["Wildest Alaska","The Cleansing","Through the Gold-Fields of Alaska to Bering Straits","White Fang","Drop City","Alaska","The Royal Mess","Going to extremes","Into the Wild","Four Quarters of Light"]
what are some inventions that leonardo da vinci invented?	["Double hull","Viola organista"]
what are some major events in venezuela?	["Machurucuto Incident"]
what are some of leonardo da vinci most famous inventions?	["Double hull","Viola organista"]
what are some of the traditions of islam?	["Zakāt","Salah","Hajj","Islamic dietary laws","Mosque Carpet","Jihad","Sawm","Halal food","Shahada","Adab"]
what are staffordshire terriers?	["Dog"]
what are the 7 countries that are part of central america?	["Honduras","El Salvador","Panama","Costa Rica","Guatemala","Gran Colombia","Belize"]
what are the 7 sacraments of the catholic church?	["Holy Orders","Confirmation","Anointing of the Sick","Sacrament of Penance","Marriage","Eucharist in the Catholic Church","Baptism","Chrismation"]
what are the beliefs of the roman catholic?	["Jesus Christ","Paul the Apostle","Saint Augustine of Hippo"]
what are the catholic holy days?	["Name day","Saint Patrick's Day","Maundy Thursday","Palm Sunday","Saint George's Day","Saint Joseph's Day","Christmas"]
what are the colonies of great britain?	["British Isles"]
what are the colors of the ny giants?	["Blue","White","Grey","Red"]
what are the eight stages of erikson's theory?	["Youth and the life cycle"]
what are the four main languages spoken in spain?	["Basque Language","Galician Language","Catalan language","Occitan language"]
what are the four nations of the united kingdom?	["Wales","England","Scotland","Northern Ireland"]
what are the important holidays of islam?	["Eid al-Fitr","Ramadan","Eid al-Adha"]
what are the landlocked countries in latin america?	["Bolivia","Honduras","Cuba","El Salvador","Guatemala","Costa Rica","Cuauhtémoc, D.F.","Great Pyramid of Tenochtitlán","Paraguay","Belize"]
what are the major cities in ukraine?	["Kiev"]
what are the major languages spoken in greece?	["Albanian language","Greek Language"]
what are the major languages spoken in the united kingdom?	["Scottish Gaelic language","Scots Language","British Sign Language","Cornish Language","Esperanto Language","English Language","Welsh Language","Irish"]
what are the major trading partners of germany?	["Madagascar","Scotland","Tuvalu","Tanzania","Nepal","United States of America","Antigua and Barbuda"]
what are the most popular religions in israel?	["Judaism"]
what are the mountains in northern italy called?	["Alps"]
what are the mountains in northern spain?	["Pyrenees"]
what are the names of ariel's six sisters?	["Aquata","Attina","Arista","Adella","Andrina","Alana"]
what are the names of harry potter movies in order?	["Harry Potter and the Half-Blood Prince","Harry Potter and the Deathly Hallows","Harry Potter and the Goblet of Fire","Harry Potter and the Philosopher's Stone","Harry Potter and the Chamber of Secrets","Harry Potter and the Order of the Phoenix","Harry Potter and the Prisoner of Azkaban"]
what are the names of michael jackson's 3 children?	["Paris-Michael Katherine Jackson","Prince Michael Jackson I","Prince Michael Jackson II"]
what are the names of michael jackson's kids?	["Paris-Michael Katherine Jackson"]
what are the names of the city states in ancient greece?	["Athens"]
what are the official colors of the dallas cowboys?	["Blue","Royal blue","White","Silver","Navy Blue"]
what are the official languages of argentina?	["Yiddish Language","Italian Language","Spanish Language"]
what are the official languages of the eu?	["English Language"]
what are the predominant religions in russia?	["Russian Orthodox Church","Islam"]
what are the religions practiced in indonesia?	["Protestantism","Hinduism","Catholicism","Islam"]
what are the school colors for harvard university?	["Crimson"]
what are the seven nations of central america?	["Honduras","El Salvador","Panama","Costa Rica","Guatemala","Gran Colombia","Belize"]
what are the sights to see in madrid?	["Paseo del Prado","Thyssen-Bornemisza Museum","Almudena Cathedral","Plaza de Cibeles","Puerta del Sol","Royal Palace of Madrid","Museo de Lazaro Galdiano","Gran Vía","Museo Nacional Centro de Arte Reina Sofía","Plaza Mayor, Madrid"]
what are the songs that justin bieber wrote?	["Catching Feelings","Down to Earth","Beauty and a Beat","All Around The World (featuring Ludacris)","Die in Your Arms","As Long As You Love Me (featuring Big Sean)","Baby","Believe","Be Alright","Boyfriend"]
what are the sports in spain?	["Spain women's national handball team","Spain men's national volleyball team","Spain national beach handball team","Spain national football team","Spain women's national volleyball team","Spain national handball team"]
what are the supreme court cases?	["Hayburn's Case","Hylton v. United States","Brown v. Board of Education","Hollingsworth v. Virginia","California v. Greenwood","Hague v. Committee for Industrial Organization","Kohl v United States","Ray v. Blair","Loving v. Virginia","Roe v. Wade"]
what are the three official languages of belgium?	["French Language","German Language","Dutch Language"]
what are the top tourist attractions in rome?	["Sistine Chapel","Piazza Navona","Roman Forum","Baths of Caracalla","Castel Sant'Angelo","Bocca della Verità","Pantheon","St. Peter's Basilica","Raphael Rooms","Colosseum"]
what are the two official languages of paraguay?	["Paraguayan Guaraní","Spanish Language"]
what art did wassily kandinsky do?	["Abstract art","German Expressionism","Expressionism","Der Blaue Reiter"]
what artistic movement did henri matisse belong to?	["Fauvism","Impressionism","Neo-impressionism","Modernism"]
what artistic style did henri rousseau work in?	["Post-Impressionism"]
what art movement did leonardo da vinci belong to?	["High Renaissance"]
what athlete am i olympics?	["The complete book of the Winter Olympics"]
what awards did marilyn monroe won?	["Golden Globe Henrietta Award for World Film Favorites"]
what awards gary paulsen won?	["Spur Award for Best Juvenile Fiction","Dorothy Canfield Fisher Children's Book Award","Regina Medal","Anne V. Zarrow Award for Young Readers' Literature","Spur Award for Best Juvenile Nonfiction","Newbery Honor"]
what band was george clinton in?	["The Parliaments","P-Funk All Stars","Funkadelic","George Clinton & Bootsy Collins","George Clinton","Parliament-Funkadelic"]
what banjo does scott avett play?	["Banjo"]
what baseball team was jackie robinson on?	["Brooklyn Dodgers"]
what basketball player is married to monica?	["Shannon Brown"]
what basketball teams has shaq played for?	["Boston Celtics","Miami Heat","LSU Tigers men's basketball","Los Angeles Lakers","Orlando Magic"]
what battles did stonewall jackson fight in?	["Battle of Manassas Station Ops.","Battle of McDowell","Battle of Port Republic","Battle of Rappahannock Station I","Battle of Chancellorsville","Battle of Front Royal","Battle of Hoke's Run","Battle of Cedar Mountain","First Battle of Winchester","Battle of Hancock"]
what bible do catholics follow?	["Book of Nehemiah","The Bible","New Testament","Old Testament"]
what boarding school did mark zuckerberg go to?	["Phillips Exeter Academy"]
what body of water does st lawrence river flow into?	["Gulf of Saint Lawrence"]
what book did benjamin franklin published?	["A Dissertation on Liberty and Necessity, Pleasure and Pain","A letter from Mr. Franklin to Mr. Peter Collinson, F.R.S. concerning the effect of lightning ; A letter of Benjamin Franklin, Esq. to Mr. Peter Collinson, F.R.S. concerning an electrical kite","A letter of advice to a young man concerning marriage","A Letter By Dr. Franklin To The Royal Academy Of Brussels","Apology for printers","A parable","The","A letter from B. Franklin to a young man","Address","America's Big Ben"]
what book did charles darwin wrote in 1859?	["The Origin of Species"]
what book did tupac write?	["The Rose That Grew from Concrete"]
what book is mark twain famous for?	["Tom Sawyer Abroad","Mark Twain's (Burlesque) Autobiography and First Romance","A Connecticut Yankee in King Arthur's Court","Pudd'nhead Wilson","Autobiography of Mark Twain","Tom Sawyer, Detective","The Adventures of Tom Sawyer","Personal Recollections of Joan of Arc","The Prince and the Pauper","Adventures of Huckleberry Finn"]
what books are written by suzanne collins?	["Gregor and the Prophecy of Bane","Gregor and the Marks of Secret","FIRE PROOF","Gregor and the Code of Claw","The Underland Chronicles Book Three","When Charlie McButton lost power","Gregor and the Curse of the Warmbloods","Catching Fire","12","Gregor the Overlander"]
what books did agatha christie wrote?	["And Then There Were None","Le Grand alibi","Ten Little Indians","Appointment with Death","Desyat Negrityat","The Man in the Brown Suit","Witness for the Prosecution"]
what books did ernest hemingway write?	["The Sun Also Rises","The Complete Short Stories of Ernest Hemingway: The Finca Vigía Edition","A Farewell to Arms","The Old Man and the Sea","A Moveable Feast","The Snows of Kilimanjaro","The Fifth Column and the First Forty-Nine Stories","For Whom the Bell Tolls","Across the River and into the Trees","Ernest Hemingway: The Collected Stories"]
what books did louis sachar wrote?	["Sixth Grade Secrets"]
what broncos are in the pro bowl?	["Peyton Manning"]
what business did andrew carnegie dominate?	["U.S. Steel"]
what cancer did jackie kennedy die of?	["Lymphoma"]
what cancer did patrick swayze?	["Pancreatic cancer"]
what can do in new york?	["Central Park"]
what capital city of brazil?	["Brasília"]
what capital of austria?	["Vienna"]
what caused the cuban rebellion in 1868?	["Ten Years' War"]
what caused the embargo against cuba?	["Fulgencio Batista"]
what celebrities has brody jenner dated?	["Jayde Nicole","Nicole Richie","Lauren Katherine Conrad"]
what century did slavery end in america?	["Western Hemisphere"]
what channel is the usa pageant on?	["us"]
what channel saints game?	["Australian rules football"]
what character did billy d williams play in star wars?	["Lando Calrissian"]
what characters does matt stone do?	["Kyle / Kenny / Jesus"]
what city and state is yale located in?	["Connecticut"]
what city did marco polo came from?	["Venice"]
what city does fulham play in?	["London"]
what city does paul ryan live in?	["Janesville"]
what city in florida has the lowest crime rate?	["Melquíades Rafael Martinez"]
what city is acadia university in?	["Canada","Nova Scotia","Wolfville"]
what city is mt lassen in?	["Shasta County"]
what city is the south rim of the grand canyon near?	["Phoenix","Grand Canyon National Park","Lake Powell"]
what city is the university of oregon state in?	["Eugene"]
what city was michael jackson born in?	["Gary"]
what club does cristiano ronaldo play for in 2010?	["Real Madrid C.F."]
what college did albert einstein go to?	["University of Zurich","Aargau Cantonal School","ETH Zurich","Luitpold Gymnasium"]
what college did brett favre?	["The University of Southern Mississippi"]
what college did deion sanders jr go to?	["Florida State University"]
what college did joakim noah?	["University of Florida"]
what college did john nash go to?	["Carnegie Mellon University","Carnegie Institute of Technology","Bluefield High School","Princeton University","Massachusetts Institute of Technology"]
what college did john nash teach at?	["Princeton University"]
what college did john stockton go to?	["Gonzaga University"]
what college did jrr tolkien go to?	["Exeter College, Oxford"]
what college did magic johnson play for?	["Michigan State University"]
what college did martin luther king jr go to?	["Morehouse College"]
what college did maya moore go to?	["University of Connecticut"]
what college did se hinton go?	["University of Tulsa"]
what college did sir isaac newton go to?	["The King's School, Grantham","Trinity College, Cambridge"]
what college football team did john elway play for?	["Stanford University"]
what colleges did albert einstein teach at?	["School of Mathematics, Institute for Advanced Study","Humboldt University of Berlin Department of Physics"]
what colleges did harper lee attend?	["Huntingdon College","University of Oxford","Monroe County High School","University of Alabama School of Law","University of Alabama"]
what colleges did mitt romney attend?	["Stanford University","Cranbrook Schools","Harvard Law School","Harvard Business School","Harvard University","Brigham Young University"]
what color jerseys do the redskins wear at home?	["White","Burgundy","Gold"]
what company does nike own?	["Converse","Hurley International"]
what concentration camp did anne frank died in?	["Bergen-Belsen concentration camp"]
what continent does armenia belong to?	["Eurasia"]
what continent does canada belong to?	["North America"]
what continent is cayman islands located?	["North America"]
what counties in florida have the lowest property taxes?	["Xanth","JoJo's Bizarre Adventure"]
what countries are in the euro dollar?	["Italy","Portugal","Finland","Luxembourg","France","Slovenia","Austria","Germany","Greece","Spain"]
what countries are in the uk yahoo?	["Scotland","England","Wales","Northern Ireland"]
what countries are involved in the nafta?	["Canada","United States of America","Mexico"]
what countries are located near egypt?	["Sudan","Israel","Red Sea","Libya"]
what countries are members of the security council?	["Verdict on Kashmir"]
what countries are near italy?	["Switzerland","Slovenia","Austria","France"]
what countries are part of the baltic?	["Latvia","Lithuania","Estonia"]
what countries are part of the uk?	["Scotland","England","Wales","Northern Ireland"]
what countries constitute the eu?	["Czech Republic","Estonia","Denmark","Finland","France","Austria","Germany","Belgium","Cyprus","Bulgaria"]
what countries does canada have trade agreements with?	["United Kingdom","Japan","United States of America"]
what countries does england border?	["Scotland"]
what countries does greece share borders with?	["Turkey","Republic of Macedonia","Albania","Lake Prespa","Bulgaria"]
what countries does nafta include?	["Canada","United States of America","Mexico"]
what countries does the arctic circle run through?	["North Greenland"]
what countries does the panama canal go through?	["Panama Canal Zone"]
what countries does tomtom western europe include?	["Belarus","Estonia","Andorra","Liechtenstein","Albania","Croatia","Gibraltar","Guernsey","Isle of Man","Jersey"]
what countries don need a visa for usa?	["us"]
what countries do the united nations help?	["Afghanistan","Albania","Angola","Algeria","Andorra","Austria","Australia","Antigua and Barbuda","Armenia","Argentina"]
what countries have english as their official language?	["Canada","Australia","Kingdom of Great Britain","United States of America","United Kingdom","Ireland","New Zealand"]
what countries have german as the official language?	["Canada","German Democratic Republic","Luxembourg","Switzerland","Liechtenstein","Germany","West Germany","Belgium","Vatican City","Second Polish Republic"]
what countries have spanish as the national language?	["Spain"]
what countries have territories in oceania?	["Northern Mariana Islands","Norfolk Island","Guam","American Samoa","New Caledonia","Marshall Islands","Kiribati","Nauru","Fiji","Cook Islands"]
what countries included in oceania?	["Northern Mariana Islands","Norfolk Island","Guam","American Samoa","New Caledonia","Marshall Islands","Kiribati","Nauru","Fiji","Cook Islands"]
what countries included in the uk?	["Scotland","England","Wales","Northern Ireland"]
what countries in the world speak chinese?	["Canada","Brunei","Singapore","Malaysia","Shěn","Vietnam","China"]
what countries makes up the uk?	["Scotland","England","Wales","Northern Ireland"]
what countries require travel visas for us citizens?	["us"]
what countries share a land border with indonesia?	["Australia","East Malaysia"]
what countries share borders with spain?	["Perejil Island","Portugal","France","Andorra","Morocco","Gibraltar"]
what countries speak english natively?	["Canada","Australia","Kingdom of Great Britain","United States of America","United Kingdom","Ireland","New Zealand"]
what countries speak french as a first language?	["Chad","Central African Republic","Comoros","Burundi","Djibouti","Congo","Belgium","Cameroon","Burkina Faso","Benin"]
what countries were part of the spanish empire?	["Honduras","Uruguay","El Salvador","Panama","Equatorial Guinea","Andorra","Guatemala","Puerto Rico","Paraguay","Belize"]
what country borders slovakia?	["Ukraine","Austria","Poland","Czech Republic","Hungary"]
what country did adolf hitler control?	["Germany"]
what country did benito mussolini govern?	["Italy"]
what country did buddha come from?	["India"]
what country did germany invade first in ww1?	["Belgium"]
what country did gregor mendel live in?	["Brno","Austrian Silesia"]
what country did hitler invaded to start ww2?	["Austria","Germany"]
what country did hitler invade that started ww2?	["Hitler Declares War on Poland"]
what country did magellan represent?	["Portugal"]
what country did the battle of san juan hill take place?	["Cuba"]
what country did toussaint l'ouverture help free?	["Haiti"]
what country does alaska belong to?	["United States of America"]
what country does david luiz play for?	["Brazil"]
what country does justin bieber come from?	["Canada"]
what country does rafael nadal play for?	["Spain"]
what country do maltese come from?	["Region of Malta"]
what country is dyson made?	["United Kingdom"]
what country is nicki minaj from?	["Trinidad and Tobago"]
what country is nike based in?	["United States of America"]
what country sponsored ferdinand magellan?	["Portugal"]
what country was king tut's tomb found?	["Ancient Egypt"]
what country was slovakia?	["Czechoslovakia"]
what country was stalin in charge of?	["Soviet Union"]
what county is brentwood tennessee in?	["Williamson County"]
what county is frederick md in?	["Frederick County"]
what county is greeley colorado in?	["Weld County"]
what county is houston tx in?	["Montgomery County"]
what county is kansas city kansas?	["Wyandotte County"]
what county is san antonio in?	["Comal County"]
what county is san diego ca?	["San Diego County"]
what county is san diego in?	["San Diego County"]
what county is san francisco?	["San Francisco"]
what county is st james city fl in?	["Lee County"]
what county is st. louis park in?	["Hennepin County"]
what county is st paul minnesota in?	["Ramsey County"]
what county is st paul nc in?	["Robeson County"]
what county is st paul va in?	["United States of America","Wise County","Russell County","Virginia"]
what county is texarkana arkansas in?	["Miller County"]
what county is utica ny in?	["Oneida County"]
what county is west st paul in?	["Dakota County"]
what currency can you use in barbados?	["Barbadian dollar"]
what currency can you use in jamaica?	["Jamaican dollar"]
what currency does australia use 2012?	["Australian dollar"]
what currency does cyprus use?	["Euro"]
what currency does dominican republic take?	["Dominican peso"]
what currency does england use now?	["UK £"]
what currency does france accept?	["CFP franc","Euro"]
what currency does russia use 2012?	["Russian ruble"]
what currency does singapore use?	["Singapore dollar"]
what currency does the czech republic use now?	["Czech koruna"]
what currency do they use in switzerland?	["Swiss franc"]
what currency is accepted in new zealand?	["New Zealand dollar"]
what currency is used in panama?	["United States dollar","Panamanian balboa"]
what currency shall i take to croatia?	["Croatian dinar"]
what currency should i take to mexico?	["Mexican peso"]
what currency should i take to turkey?	["Turkish lira"]
what currency should take to mexico?	["Mexican peso"]
what currency should you take to morocco?	["Moroccan dirham"]
what currency should you take to vietnam?	["Vietnamese dong"]
what currency to take to barbados?	["Barbadian dollar"]
what currency to take to turkey 2010?	["Turkish lira"]
what date did sally pearson won gold?	["2008 Summer Olympics","2012 Summer Olympics"]
what degree did martin luther king earn?	["Bachelor of Divinity","Bachelor of Arts","PhD"]
what degrees did barack obama get?	["Juris Doctor","Bachelor of Arts"]
what degrees did obama get in college?	["Juris Doctor","Bachelor of Arts"]
what degrees does romney have?	["Juris Doctor","MBA","Bachelor of Arts"]
what did african americans do during the revolutionary war?	["Continental Army Regiment"]
what did albert speer design?	["Deutsches Stadion","Volkshalle","Reich Chancellery","Olympic Stadium"]
what did alice paul accomplish?	["Silent Sentinels","National Woman's Party"]
what did andrew johnson accomplish as president?	["Reconstruction after the Civil War"]
what did andy irons die from?	["Myocardial infarction"]
what did anton van leeuwenhoek contribute to our knowledge of cells?	["microscope first used by anton van leeuwenhoek"]
what did baron de montesquie influence?	["charles-louis de secondat montesquieu influenced edward gibbon"]
what did bernie mac died of?	["Pneumonia"]
what did bobby darin die of?	["Surgical complications"]
what did bruce jenner win gold medal for?	["Decathlon challenge"]
what did canada get gold medals in?	["Diving at the 1984 Summer Olympics - Women's 3 metre springboard"]
what did charles babbage discover?	["The Difference Engine: Charles Babbage and the Quest to Build the First Computer"]
what did coretta scott king died from?	["Respiratory failure"]
what did dmitri mendeleev discover in 1869?	["Periodic Table"]
what did drew barrymore go to rehab for?	["Cocaine","Alcoholic beverage"]
what did drita find out?	["Football Superleague of Kosovo"]
what did dr jack kevorkian do?	["Assisted suicide"]
what did dr josef mengele do?	["Physician"]
what did dr. seuss do?	["Writer"]
what did elliot stabler do?	["Law & Order: Special Victims Unit","New York City Police Department"]
what did elvis presley died from?	["Myocardial infarction"]
what did ferdinand magellan do?	["Navigator","Explorer"]
what did franz liszt do to earn a living?	["Priest","Pianist","Composer","Virtuoso"]
what did fred durst do?	["Musician"]
what did f. scott fitzgerald do?	["Poet","Novelist","Writer"]
what did galileo do to become famous?	["Astronomer"]
what did general robert e lee die from?	["Pneumonia"]
what did george clemenceau do?	["Newspaper","Physician","Statesman","Publisher"]
what did george orwell died of?	["Tuberculosis"]
what did george washington carver made?	["Peanut butter"]
what did george washington do as a teenager?	["Surveyor"]
what did gerald r ford die from?	["Cardiovascular disease"]
what did gloria steinem founded?	["Coalition of Labor Union Women","National Women's Political Caucus","New York Media Holdings, LLC","Women's Action Alliance","Choice USA","Feminist Majority Foundation","Ms. Foundation for Women"]
what did hayes do?	["President of the United States","Governor of Ohio"]
what did hitler use to kill himself?	["Gunshot","Suicide"]
what did isaac newton explain?	["Newton fractal","Newton–Euler equations","Newton's laws of motion","Newton's cannonball","Newton","Newton's inequalities","Newton's notation","Newton polygon","Newton disc"]
what did jack london do for a living?	["Author","Sailor","Journalist","Novelist","Screenwriter","Essayist"]
what did james chadwick invent?	["Neutron"]
what did james k polk do before he was president?	["Lawyer"]
what did james polk do before he was president?	["United States Naval Academy"]
what did jesse owens won?	["Associated Press Male Athlete of the Year"]
what did jesus do for living?	["Preacher","Prophet","Carpenter"]
what did joan crawford died of?	["Myocardial infarction","Pancreatic cancer"]
what did joe biden study in college?	["Political Science","History"]
what did john dalton study?	["Chemist"]
what did john hancock do for the american revolution?	["Articles of Confederation","United States Declaration of Independence"]
what did john irving wrote?	["Trying to Save Piggy Sneed","The Fourth Hand","The Cider House Rules","The 158-Pound Marriage","The World According to Garp","The Hotel New Hampshire","A Widow for One Year","A Prayer for Owen Meany","The Water-Method Man","Until I Find You"]
what did king henry viii rule?	["England"]
what did laura ingalls wilder wrote?	["On the Banks of Plum Creek","The Long Winter","Farmer Boy","Little House in the Big Woods","West from Home","These Happy Golden Years","The First Four Years","Little Town on the Prairie","By the Shores of Silver Lake","On the Way Home"]
what did lincoln steffens wrote?	["The shame of the cities"]
what did mark zuckerberg study?	["Harvard University"]
what did martha graham train as?	["Screenwriter","Choreographer"]
what did mary wollstonecraft fight for?	["Women's rights"]
what did michael crabtree do?	["Wide receiver"]
what did miles davis died of?	["Pneumonia","Stroke","Respiratory failure"]
what did napoleon bonaparte do as emperor?	["After graduating from military school in 1785, Napoleon became a Second-Lieutenant of Artillery in the regiment of La Fere, garrisoned at Valence, in southern France where he studied military tactics and strategy and the philosophical works of Voltaire and Rousseau."]
what did neil armstrong say when he landed on the moon?	["That's one small step for man, one giant leap for mankind."]
what did nicholas copernicus discover?	["He discovered that other ancient Greeks had suggested the idea of a heliocentric universe, and this seemed better seemed even though it still needed complex mathematical calculations to predict planetary movement."]
what did nicolas cage name his son?	["Kal-El Coppola Cage","Weston Coppola Cage"]
what did niels bohr discover about the atomic structure?	["Bohr began to develop a model of the atom in which electrons were disposed in rings around the nucleus -- a first step towards an explanation of atomic structure."]
what did nikola tesla invented that is of use today?	["Tesla coil"]
what did obama do before he was elected president?	["Illinois State Senator"]
what did pamela courson die from?	["Heroin overdose","Drug overdose"]
what did peter tchaikovsky do?	["Composer"]
what did president carter do in office?	["Social development","Human rights","Economic development"]
what did queen victoria say about the suffragettes?	["I am every day more convinced that we women, if we are to be good women, feminine and amiable and domestic, are not fitted to reign; at least it is they that drive themselves to the work which it entails."]
what did randy savage died of?	["Myocardial infarction","Traffic collision"]
what did romo do?	["Baseball player"]
what did scott joplin play?	["Piano","Jazz piano"]
what did shakespeare become famous for?	["Poet","Playwright","Dramatist","Lyricist","Author"]
what did shakespeare learn in grammar school?	["william shakespeare performed play by thomas dekker"]
what did shannon hoon die from?	["Drug overdose"]
what did st augustine do?	["Physician","Writer","Philosopher"]
what did stephen hawking become famous for?	["Author","Mathematician","Professor","Writer","Cosmologist","Physicist","Actor","Astronomer","Scientist","Science writer"]
what did stephen hawking study?	["Physics"]
what did steve mcnair died from?	["Ballistic trauma"]
what did st. nicholas do in his life?	["Bishop"]
what did the akkadian empire include?	["Babylonia","Assyria"]
what did the ancient mayans predict?	["The Hero Twins","Mayeros","Sacred Mysteries Among The Mayas and The Quiches","The mystery of the Maya","The End Of Time","The Mayan prophecies","2012"]
what did the ancient romans speak?	["Latin Language"]
what did the blackfoot indians speak?	["English Language","Blackfoot Language"]
what did the islamic people believe in?	["Zakāt","Salah","Hajj","Islamic dietary laws","Jihad","Sawm","Halal food","Shahada","Adab"]
what did the scientist chadwick discovered?	["Neutron"]
what did thomas edison do for the world?	["Phonograph","Carbon microphone","Mimeograph","Quadruplex telegraph","Electric power distribution","Movie camera","Incandescent light bulb","Phonograph cylinder"]
what did thomas hobbes do?	["Political philosophy"]
what did thomas jefferson do before he became president?	["Statesman","Author","Writer","Philosopher","Architect","Lawyer","Farmer","Archaeologist","Teacher","Inventor"]
what did thomas malthus do?	["Mathematician","Demographer","Scientist","Economist"]
what did vera ellen die from?	["Cancer"]
what did warren buffett invest in?	["Berkshire Hathaway"]
what did werner heisenberg discover?	["Matrix mechanics"]
what did whoopi goldberg won a grammy for?	["Grammy Award for Best Comedy Album"]
what discovery did galileo make?	["Ganymede","Callisto","Europa","Galilean moons","Io"]
what disease did abraham lincoln had?	["Marfan syndrome","Smallpox","Strabismus"]
what disease did anne frank die of?	["Typhus"]
what disease did bernie mac die of?	["Pneumonia"]
what disease did patrick swayze died from?	["Pancreatic cancer"]
what disease does robin roberts have?	["Breast cancer"]
what district does nancy pelosi represent?	["California’s 5th congressional district","California’s 8th congressional district","California’s 12th congressional district"]
what do australians call bigfoot?	["Waleed Aly"]
what do christians believe about heaven hell and purgatory?	["Greek Evangelical Church","The Church of Nails"]
what document did james madison write?	["The Federalist Papers","The Papers of James Madison: Presidential Series","The Papers of James Madison: Congressional Series","The Papers of James Madison: Secretary of State Series","The Papers of James Madison","The Papers of James Madison: Retirement Series"]
what document did thomas jefferson wrote?	["Notes on the State of Virginia","Jefferson abroad","Jefferson the man","Jefferson in love","United States Declaration of Independence","Jefferson on Jefferson","Ye","Jefferson Bible","Citizen Jefferson","Light and liberty"]
what does a dream deferred by langston hughes?	["Dreams and Youth"]
what does anne frank died of?	["Typhus"]
what does australia use for currency?	["Australian dollar"]
what does barbara bush do for work?	["First Lady"]
what does bentley mean?	["Bentley Motors Limited"]
what does bolivia border?	["Brazil"]
what does british colony mean?	["British American"]
what does david beckham play?	["Midfielder"]
what does egfr african american mean on a blood test?	["Protein"]
what does george wilson do for a living?	["American football player"]
what does gm make?	["Automobile"]
what does god shiva represent?	["Hinduism"]
what does helen flanagan do?	["Actor"]
what does jamaican people speak?	["Jamaican Creole English Language","Jamaican English"]
what does janelle brown work?	["Actor"]
what does joey jordison play in slipknot?	["Drums"]
what does julian lennon do?	["Singer","Writer","Guitarist","Musician","Actor","Singer-songwriter","Record producer"]
what does kim kardashian work as?	["Entrepreneur","Model","Businessperson","Actor"]
what does lauren conrad major in?	["Fashion design"]
what does matt damon play in?	["American Teacher","Contagion","Che: Part Two","All the Pretty Horses","Courage Under Fire","Dogma","Behind the Screens","Confessions of a Dangerous Mind","Elysium","Chasing Amy"]
what does monsanto own?	["Agricultural Chemicals","Seed","Agriculture","Chemical industry"]
what does ringo sing?	["Yellow Submarine","Pinocchio Medley (Do","Good Night","I Shall Be Released","Roll Over Beethoven","Tommy's Holiday Camp","Sweet Little Sixteen","California Calling","Honey Don't","Don’t Pass Me By"]
what does sarabi?	["Physician"]
what does ss stand for in hitler's army?	["Schutzstaffel"]
what does the missouri river bisect?	["Mississippi River"]
what does the sun in the philippine flag represent?	["Province of the Philippines"]
what does wh smith stand for?	["William Henry Smith"]
what do people in australia speak?	["Lojban","Esperanto Language","English Language"]
what do people in czech republic speak?	["Croatian language"]
what do people in france like to do for fun?	["Cycling"]
what do people in jamaica speak?	["Jamaican Creole English Language","Jamaican English"]
what do people speak in canada?	["French Language","English Language"]
what do people speak in germany?	["Bavarian Language","German Language","Saxon, Upper Language"]
what do people speak in uk?	["Scottish Gaelic language","Scots Language","British Sign Language","Cornish Language","Esperanto Language","English Language","Welsh Language","Irish"]
what do portuguese people speak?	["Portuguese"]
what do see in paris?	["Musée Maillol","Palace of Versailles","Eiffel Tower","Île de la Cité","Café Volpini","Notre Dame de Paris","Folies Bergère","Arc de Triomphe","Basilica of the Sacré Cœur","Panthéon, Paris"]
what do the symbols on the nevada flag mean?	["All For Our Country"]
what do they call money in japan?	["Japanese yen"]
what do they do in cuba for fun?	["¡Cuba! Art and History from 1868 to Today"]
what do they speak in norway?	["Nynorsk","Norwegian Language","Bokmål"]
what do they speak in scotland?	["Scottish English"]
what do they think happened to natalee holloway?	["Aruba: The Tragic Untold Story of Natalee Holloway and Corruption in Paradise"]
what do unitarian universalist believe?	["Nontrinitarianism"]
what do we call the currency of france?	["French franc"]
what do you call members of the senate?	["Senator"]
what do you call the chinese writing system?	["Standard Mandarin"]
what drink did john pemberton create?	["Coca-Cola"]
what drug killed marilyn monroe?	["Barbiturate"]
what drugs lindsay lohan abuse?	["Cocaine","Alcoholic beverage"]
what electorate does anna bligh represent?	["Electoral district of South Brisbane"]
what else did alexander graham bell invent other than the telephone?	["Graphaphone"]
what else did ben franklin invent?	["Lightning rod","Franklin stove","Bifocals","Glass harmonica"]
what else has jennifer lawrence played in?	["The Poker House","The Hunger Games","Garden Party","The Burning Plain","Like Crazy","Winter’s Bone","The Beaver","X-Men: First Class","Devil You Know","House at the End of the Street"]
what episode of how i met your mother is carrie underwood on?	["Hooked"]
what events lead to the battle of antietam?	["Maryland Campaign","American Civil War"]
what factors led to the rise of the roman empire?	["Ulpian"]
what famous people are from barbados?	["Owen Arthur","John Michael Geoffrey Manningham Adams","Gregory Goodridge","Hugh Gordon Cummins","Anne Cools","Errol Barrow","William T. Shorey","Grantley Herbert Adams","Lloyd Erskine Sandiford","Robert Bailey"]
what famous people are from el salvador?	["William Torres Alegria","Ana Sol Gutierrez","Julio Enrique Martínez","Andrés Eduardo Menéndez","Erwin Raphael McManus","Willian Renderos Iraheta","Óscar Navarro","Ruben Cedillos","Roberto Carlos Martinez","Raul Antonio Garcia"]
what famous people came from delaware?	["Ruth Ann Minner","Beau Biden","Jack Markell","Matthew P. Denn","Michael Castle","Daniel Rodney","Jeffrey W. Bullock"]
what films has daniel craig been in?	["The Invasion","Casino Royale","Munich","Enduring Love","Layer Cake","A Kid in King Arthur's Court","The Jacket","The Mother","Sylvia","Road to Perdition"]
what films has scarlett johansson been in?	["Girl with a Pearl Earring","Fall","A Good Woman","A Love Song for Bobby Long","Don Jon's Addiction","Eight Legged Freaks","Ghost World","Captain America: The Winter Soldier","An American Rhapsody"]
what flower is on the oklahoma quarter?	["Scissor-tailed Flycatcher"]
what fma stands for?	["FullMetal Alchemist"]
what football team does mike wright play for?	["New England Patriots"]
what football team is michael vick on?	["Philadelphia Eagles"]
what form of currency does china have?	["Renminbi"]
what form of currency does germany use?	["Euro"]
what form of government does australia use?	["Parliamentary system","Federation","Constitutional monarchy"]
what form of government does canada?	["Parliamentary system","Federation","Constitutional monarchy","Multi-party system"]
what form of government does north korea have?	["Single-party state","Socialist state","People's Republic","Juche","Unitary state"]
what form of government does the united states have?	["Presidential system","Federal republic","Representative democracy","Two-party system","Constitutional republic","Republic"]
what form of government does the united states use?	["Presidential system","Federal republic","Representative democracy","Two-party system","Constitutional republic","Republic"]
what form of government do we have in the philippines?	["Constitutional republic","Presidential system","Republic","Unitary state"]
what form of government is the uk?	["Parliamentary system","Unitary state","Constitutional monarchy","Hereditary monarchy"]
what galileo galilei was famous for?	["Solar System","Heliocentrism","Kinematics","Galilean moons"]
what games will be on nfl network this year?	["New York Jets","Carolina Panthers","Denver Broncos","Baltimore Ravens","Detroit Lions","Kansas City Chiefs","Arizona Cardinals","New York Giants","Jacksonville Jaguars","Oakland Raiders"]
what genre of art is the mona lisa?	["Portrait"]
what government did the roman empire have?	["Family dictatorship","Monarchy","Autocracy","Dictatorship"]
what government does iraq use?	["Prime Minister of Iraq","President of Iraq"]
what government does new zealand have?	["Parliamentary system","Unitary state","Constitutional monarchy"]
what guitar did joe walsh play?	["Fender Stratocaster"]
what guitar did kurt cobain?	["Fender Jag-Stang"]
what guitar does corey taylor play?	["guitar","bass guitar","Drum"]
what happened after mr. sugihara died?	["Yaotsu"]
what happened at benghazi?	["2012 U.S. diplomatic missions attacks","2012 U.S. Consulate attack in Benghazi","First Battle of Benghazi","Second Battle of Benghazi"]
what happened at chernobyl?	["Nuclear accident","Industrial disaster"]
what happened in bosnia in the 90s?	["Yugoslav Wars","Operation Tiger","Croat–Bosniak War","Operation Deny Flight","Operation Summer '95","Operation Sana","Bosnian War","Operation Mistral","Battle of the Bosnian Highlands","NATO intervention in Bosnia and Herzegovina"]
what happened to dunkirk during ww2?	["Battle of Dunkirk"]
what happened to jill valentine?	["BSAA"]
what happened to pope john paul ii?	["Myocardial infarction","Parkinson's disease"]
what has angelina jolie accomplished?	["Golden Globe Award for Best Supporting Actress - Series, Miniseries or Television Film","Academy Award for Actress in a Supporting Role","BFCA Critics' Choice Award for Best Supporting Actress","Golden Globe Award for Best Performance by an Actress In A Mini-series or Motion Picture Made for Television","Satellite Award for Best Actress – Miniseries or Television Film","People's Choice Award for Favorite Female Action Star","Satellite Award for Best Actress – Motion Picture Drama","Golden Globe Award for Best Supporting Actress - Film"]
what has ashley greene been in?	["Skateland","New Moon","Radio Free Albemuth","A Warrior's Heart","Eclipse","Summer's Blood","King of California","The Apparition","Twilight","The Twilight Saga: Breaking Dawn - Part 1"]
what has charlie hunnam been in?	["Deadfall","Nicholas Nickleby","Pacific Rim","Green Street","Frankie Go Boom","The Ledge","Children of Men","Abandon","Cold Mountain","Whatever Happened to Harold Smith?"]
what has ian somerhalder acted in?	["Smallville","The Vampire Diaries","Lost","Tell Me You Love Me","Fearless","Young Americans"]
what has kristen stewart acted in?	["New Moon","Eclipse","The Runaways","Snow White and the Huntsman","Twilight","The Twilight Saga: Breaking Dawn - Part 1"]
what has shannen doherty played in?	["Girls Just Want to Have Fun","A Burning Passion: The Margaret Mitchell Story","Category 7: The End of the World","Freeze Frame","Christmas Caper","Burning Palms","Another Day","Blindfold: Acts of Obsession","Almost Dead","Friends 'Til the End"]
what hemisphere is africa located in?	["Northern Hemisphere","Southern Hemisphere"]
what highschool did emily osment go to?	["Flintridge Preparatory School"]
what highschool did harper lee go to?	["Monroe County High School"]
what high school did lil wayne graduate from?	["Mcmain Magnet Secondary School"]
what high school did maya angelou go to?	["George Washington High School"]
what highschool did r. kelly attend?	["Kenwood Academy"]
what honor did agatha christie receive in 1971?	["Dame Commander of the Order of the British Empire"]
what industry does walmart operate in?	["Department Stores","Retail","Variety Stores"]
what influenced john steinbeck to start writing?	["William Faulkner","Robert Burns","Sherwood Anderson","Thomas Malory"]
what influenced william shakespeare to start writing?	["Thomas More","Ovid","Geoffrey Chaucer","Plutarch","Terence","Thomas Kyd","Plautus","Michel de Montaigne","John Pory","Christopher Marlowe"]
what inspired michael jackson to become a singer?	["Redd Foxx","Charlie Chaplin","James Brown","Nipsey Russell","Walt Disney"]
what inspired michelangelo buonarroti?	["Lorenzo de' Medici","Domenico Ghirlandaio","Giovanni Pico della Mirandola","Girolamo Savonarola","Melozzo da Forlì"]
what inspired steinbeck?	["William Faulkner","Robert Burns","Sherwood Anderson","Thomas Malory"]
what instrument did robin gibb play?	["Violin","Piano"]
what instrument does louis armstrong?	["Trumpeter"]
what instruments did louis armstrong play?	["trumpet","Cornet"]
what instruments does justin bieber use?	["guitar","Piano","trumpet","Drums"]
what international organizations is china part of?	["United Nations","G-20 major economies","Caribbean Development Bank","Asian Development Bank","Shanghai Cooperation Organisation","African Development Bank","World Bank","Asia-Pacific Economic Cooperation"]
what inventions did thomas edison invent list?	["Phonograph","Carbon microphone","Mimeograph","Quadruplex telegraph","Electric power distribution","Movie camera","Incandescent light bulb","Phonograph cylinder"]
what inventions were made by ben franklin?	["Lightning rod","Franklin stove","Bifocals","Glass harmonica"]
what is arkansas state capitol?	["Little Rock"]
what is armenian currency?	["Armenian dram"]
what is berkshire hathaway invested in?	["MOODY'S CORP Common Stock","BURLINGTON NORTHERN SANTA FE Common Stock"]
what is capital city of morocco?	["Rabat"]
what is carlos pena jr nationality?	["Dominican Republic"]
what is charlie chaplin famous for?	["Comedian"]
what is cindy sherman known for?	["Photographer"]
what is claire danes famous for?	["Actor"]
what is colorado technical university?	["Career Education Corporation"]
what is ella fitzgerald parents name?	["William Fitzgerald","Temperance Tempie Fitzgerald"]
what is eminem's real full name?	["Marshall Bruce Mathers, Jr."]
what is houston timezone?	["Central Time Zone"]
what is jacksonville fl timezone?	["North American Eastern Time Zone"]
what is jamie oliver children names?	["Petal Blossom Rainbow Oliver","Poppy Honey Rosie Oliver","Daisy Boo Pamela Oliver","Buddy Bear Maurice Oliver"]
what is jamie spears baby name?	["Bryan Spears"]
what is jimi hendrix purple haze about?	["Drug overdose"]
what is john edwards indicted for?	["Political corruption"]
what is kentucky state slogan?	["United we stand, divided we fall"]
what is lamar odom doing now july 2012?	["Los Angeles Clippers"]
what islands did darwin study finches on?	["The purpose of the expedition, which lasted for nearly four years, was to survey the east and west coasts of South America, but it also took in the Cape Verde Islands, the Galapagos, Tahiti, New Zealand, Australia, Mauritius and South Africa."]
what is lawton ok zip code?	["73502","73501","73506","73507","73505"]
what is london uk time zone?	["Greenwich Mean Time"]
what is los angeles california time zone?	["Pacific Time Zone"]
what is malaysian currency?	["Malaysian ringgit"]
what is michael kors best known for?	["Fashion Designer"]
what is michael kors real name?	["Karl Anderson"]
what is modern day judah?	["Jerusalem"]
what is money called in italy?	["Euro"]
what is monta ellis career high points?	["NBA Most Improved Player Award"]
what is my timezone in louisiana?	["Central Time Zone","UTC−06:00"]
what is my timezone in pennsylvania?	["UTC-5","North American Eastern Time Zone"]
what is newcastle metro?	["Tyne and Wear"]
what is new france?	["North America"]
what is newt gingrich's wife's name?	["Callista Gingrich"]
what is new york city airport?	["Flushing Airport","Mitchel Air Force Base","Downtown Manhattan Heliport","LaGuardia Airport","John F. Kennedy International Airport","New York Skyports Inc. Seaplane Base","East 34th Street Heliport"]
what is penn state's main campus?	["University Park"]
what is president nixon's first name?	["Richard"]
what is real name of santa claus?	["Saint Nicholas"]
what is rihanna mum called?	["Monica Braithwaite"]
what is ryan seacrest radio show?	["On Air with Ryan Seacrest","American Top 40"]
what is samuel langhorne clemens well known for?	["Lecturer","Author","Writer","Journalist","Novelist","Humorist"]
what is san francisco zip code?	["94109","94108","94102","94101","94103","94111","94105","94104","94107","94110"]
what is serbian language called?	["Serbian language"]
what is sir isaac newton theory?	["Newton's laws of motion"]
what is spoken in czech republic?	["Greek Language","Ukrainian Language","Croatian language","Serbian language","Hungarian language","Bulgarian Language","Czech Language","German Language","Romani language","Slovak Language"]
what is st anthony patron saint of?	["Padua"]
what is steve nash nationality?	["Canada"]
what is tatu baby's real name?	["Yulia Volkova"]
what is the australian dollar called?	["Australian dollar"]
what is the average temperature in phoenix az in december?	["Phoenix should not be contained in Maricopa County."]
what is the best currency to take to turkey?	["Turkish lira"]
what is the best sandals resort in st lucia?	["Micoud Quarter","Choiseul Quarter","Praslin Quarter","Vieux Fort Quarter","Castries Quarter","Laborie Quarter","Gros Islet Quarter","Anse la Raye Quarter","Dauphin Quarter","Dennery Quarter"]
what is the best tour to egypt?	["eg"]
what is the best zelda game to start with?	["The Legend of Zelda: Ocarina of Time"]
what is the capital city of spain wiki answers?	["Madrid"]
what is the capital of australia victoria state?	["Melbourne"]
what is the capital of italy today?	["Rome"]
what is the capital of modern day egypt?	["Cairo"]
what is the capital of modern egypt?	["Cairo"]
what is the capital of republic of ireland?	["Dublin"]
what is the clemson mascot name?	["The Tiger and the Cub","The Clemson Tiger"]
what is the country code for mexico?	["mx"]
what is the currency in egypt 2012?	["Egyptian pound"]
what is the currency in italy?	["Euro"]
what is the currency in turkey called?	["Turkish lira"]
what is the currency of brazil now?	["Brazilian real"]
what is the currency of germany now?	["Euro"]
what is the currency of puerto rico called?	["United States dollar"]
what is the currency of sweden in 2010?	["Swedish krona"]
what is the currency of the czech republic?	["Czech koruna"]
what is the currency used in italy?	["Euro"]
what is the current time in bangalore india?	["UTC+05:30"]
what is the current time in kauai hawaii?	["Hawaii–Aleutian Time Zone","UTC−10:00"]
what is the dominant language spoken in jamaica?	["Jamaican English"]
what is the dominant religion in the us?	["Christianity"]
what is the government of france for 2010?	["Constitutional republic"]
what is the government system of malaysia?	["Parliamentary system","Federal monarchy","Federation","Constitutional monarchy","Elective monarchy"]
what is the government system of saudi arabia?	["Absolute monarchy","Islamic state","Unitary state"]
what is the head judge of the supreme court called?	["Chief Justice of the United States"]
what is the holy book of the buddhist religion?	["Amitabha Sutra","Tibetan Buddhist canon","Mahāvastu","Āgama","Srimala Sutra","Longchen Nyingthig","Gangōji Garan Engi","Mahayana sutras","Vimalakirti Sutra","Pāli Canon"]
what is the islamic belief?	["God in Islam","Monotheism","Qiyamah","Predestination in Islam","Tawhid","Masih ad-Dajjal","Islamic holy books","Prophets in Islam","Islamic view of angels"]
what is the kentucky state bird?	["Cardinal"]
what is the language of russia s spoken?	["Yiddish Language","Chuvash Language","Russian Language","Tatar Language","Ukrainian Language"]
what is the largest nation in europe?	["Russia"]
what is the main language spoken in mexico?	["Spanish Language"]
what is the main language used in china?	["Chinese language"]
what is the milwaukee brewers mascot?	["Bonnie Brewer","Bernie Brewer"]
what is the milwaukee brewers stadium called?	["Miller Park"]
what is the money of switzerland called?	["Swiss franc"]
what is the most common language in norway?	["Norwegian Language"]
what is the most common language spoken in argentina?	["Spanish Language"]
what is the most populated state in united states?	["California"]
what is the name of airport in new york?	["Flushing Airport","Mitchel Air Force Base","Downtown Manhattan Heliport","LaGuardia Airport","John F. Kennedy International Airport","New York Skyports Inc. Seaplane Base","East 34th Street Heliport"]
what is the name of king george vi wife?	["Queen Elizabeth The Queen Mother"]
what is the name of sonia gandhi daughter?	["Priyanka Vadra"]
what is the name of the book hitler wrote in jail?	["Mein Kampf"]
what is the name of the capital of belgium?	["City of Brussels"]
what is the name of the currency used in china?	["Renminbi"]
what is the name of the currency used in italy?	["Euro"]
what is the name of the currency used in peru?	["Peruvian nuevo sol"]
what is the name of the currency used in switzerland?	["Swiss franc"]
what is the name of the national anthem of canada ( 2 words )?	["O Canada"]
what is the name of the san francisco newspaper?	["The San Francisco Examiner","California Star","San Francisco Bay Guardian","San Francisco Business Times","San Francisco Bay Times","San Francisco Chronicle","Bay Area Reporter","Sing Tao Daily","AsianWeek","San Francisco Call"]
what is the name of the speaker of the house of representatives now 2011?	["Nancy Pelosi"]
what is the national flower of hawaii?	["Hawaiian hibiscus"]
what is the national language of iran?	["Persian Language"]
what is the new movie john carter about?	["Adventure film","Science Fiction","Action film","Fantasy"]
what is the nigeria time?	["West Africa Time","UTC+01:00"]
what is the official language of brazil now?	["Portuguese Language"]
what is the only colony on the south america continent?	["French Guiana"]
what is the oregon ducks 2012 football schedule?	["University of Oregon"]
what is the parliament of nepal called?	["Parliament of Nepal","Constituent assembly","Nepal House of Representatives","Nepalese Constituent Assembly","National Assembly of Nepal"]
what is the percentage of youth in uganda?	["Uganda"]
what is the political structure of china?	["Single-party state","Communist state","Socialist state"]
what is the political system in germany?	["Constitutional republic","Multi-party system","Federal republic","Democracy","Parliamentary republic"]
what is the political system of south africa?	["Federation","Democracy","Dominant-party system","Presidential system","Parliamentary system","Liberal democracy","Republic","Parliamentary republic"]
what is the predominant religion in israel?	["Judaism"]
what is the primary language of china?	["Standard Mandarin"]
what is there to do for fun in kansas city?	["Kemper Arena","Starlight Theatre","Kauffman Stadium","Municipal Stadium","Ward Parkway Center","Arrowhead Stadium","Blue Ridge Mall","Blue Ridge Crossing","Crown Center","TWA Corporate Headquarters' Building"]
what is there to do in peoria illinois?	["Peoria Zoo","Judge Flanagan Residence","George L. Luthy Memorial Botanical Garden","Lakeview Museum of Arts and Sciences","WeaverRidge Golf Club","Heart of Illinois Fair","Wildlife Prairie State Park","Par-A-Dice Hotel and Casino","Peoria Civic Center","O'Brien Field"]
what is there to see in sydney australia?	["Sydney Opera House"]
what is the sacred text of daoism?	["Tao Te Ching"]
what is the second biggest state in the united states?	["Hawaii"]
what is the song anna kendrick sings in pitch perfect?	["Cups"]
what is the space needle in toronto?	["CN Tower"]
what is the stanley cup named after?	["Frederick Stanley, 16th Earl of Derby"]
what is the state flower of arizona?	["Saguaro"]
what is the state flower of new mexico?	["Yucca flower"]
what is the state motto of ohio?	["With God, all things are possible"]
what is the state name of new york city?	["New York"]
what is the state of montana known for?	["United States Senate elections, 2006","Battle of Canyon Creek","Hayfield Fight","Crow War","Smith Mine disaster","Nez Perce War"]
what is the theme of scarlet letter by nathaniel hawthorne?	["Dark romanticism"]
what is the title of george bush's new book?	["National Strategy for Homeland Security"]
what is the university of georgia known for?	["Georgia Bulldogs basketball"]
what is the zip code for azle texas?	["76098","76020"]
what is the zip code for concord?	["94529","94518","94519","94522","94521","94520","94527","94524"]
what is the zip code for jonesboro ar?	["72404","72401","72402","72403"]
what is the zip code for midland tx?	["79702","79710","79708","79706","79707","79704","79705","79711","79703","79701"]
what is the zip code for morgantown wv?	["26508","26501","26502","26504","26505","26506","26507"]
what is the zip code for newark california?	["94560"]
what is the zip code for nogales az?	["85662","85628","85621"]
what is the zip code for princeton nj?	["08544"]
what is the zip code for schenectady new york?	["12325","12305","12304","12307","12306","12301","12303","12302","12345","12308"]
what is the zip code for trenton?	["08610","08611","08618","08608","08603","08602","08601","08607","08605","08604"]
what is the zip code for walnut creek?	["94597"]
what is the zip code for wyoming michigan?	["49519","49509"]
what is the zip code of syracuse ny?	["13207","13206","13205","13204","13203","13202","13201","13212","13209","13208"]
what is utah's state capitol?	["Salt Lake City"]
what is warren g harding most known for?	["President of the United States"]
what is william taft famous for?	["President of the United States"]
what is william taft known for?	["President of the United States"]
what jamaican money called?	["United States dollar"]
what jobs did john adams have before he was president?	["Vice President of the United States"]
what jobs did robert burns have?	["Poet","Writer","Bard","Author"]
what killed john bonham?	["Inhalation of vomit"]
what kind government does egypt have?	["Semi-presidential system","Constitutional republic","Republic","Unitary state"]
what kind of cancer did carl wilson have?	["Lung cancer"]
what kind of cancer did farrah fawcett die of?	["Anal cancer"]
what kind of currency does dominican republic use?	["Dominican peso"]
what kind of currency does mexico use?	["United States dollar"]
what kind of currency does the dominican republic have?	["Dominican peso"]
what kind of disease does montel williams have?	["Multiple sclerosis"]
what kind of equipment did isaac newton use?	["Reflecting telescope"]
what kind of government did the united states have after the revolution?	["Presidential system","Federal republic","Representative democracy","Two-party system","Constitutional republic","Republic"]
what kind of government does brazil has?	["Constitutional republic","Presidential system","Federal republic"]
what kind of government does cuba have today?	["Semi-presidential system","Socialist state","Republic","Unitary state"]
what kind of government does iran have after 1979?	["Islamic republic","Theocracy","Unitary state"]
what kind of government does japan have now?	["Parliamentary system","Unitary state","Constitutional monarchy"]
what kind of government does libya have today?	["Provisional government","Parliamentary republic"]
what kind of government does peru?	["Presidential system"]
what kind of government does poland have?	["Parliamentary republic","Democracy"]
what kind of government does the united states have currently?	["Federal republic"]
what kind of government is egypt?	["Semi-presidential system","Constitutional republic","Republic","Unitary state"]
what kind of government is mali?	["Semi-presidential system","Republic","Unitary state"]
what kind of government is south korea?	["Sovereign state"]
what kind of government is sweden?	["Representative democracy","Unitary state","Parliamentary system","Constitutional monarchy","Hereditary monarchy","Multi-party system"]
what kind of government system did ancient egypt have?	["Government of Egypt"]
what kind of guitar did george harrison use?	["Fender Stratocaster","Rickenbacker 360/12"]
what kind of guitar did jerry garcia play?	["Fender Stratocaster","Gibson SG","Gibson Les Paul"]
what kind of guitar john mayer?	["Fender Stratocaster"]
what kind of hispanic is selena gomez?	["Mexicans"]
what kind of language do egyptian speak?	["Modern Standard Arabic"]
what kind of language does colombia speak?	["Wiwa language","Uw Cuwa","Andoque language","Spanish Language","Camsá Language","Cogui Language","Guambiano Language","Páez language","Arhuaco Language"]
what kind of language does egypt speak?	["Modern Standard Arabic"]
what kind of language does france speak?	["Provençal Language","Occitan language","French Language","Basque Language","Esperanto Language","Corsican Language","Alsatian language","Catalan language","West Flemish","Breton"]
what kind of language does turkey speak?	["Turkish Language"]
what kind of language do they speak in iran?	["Turkmen Language","Pashto language","Kurdish language","Gilaki Language","Assyrian Neo-Aramaic Language","Azerbaijani language","Armenian Language","Persian Language","Mazanderani Language","Luri language"]
what kind of leukemia did jill clayburgh have?	["B-cell chronic lymphocytic leukemia"]
what kind of monarchy does japan have?	["Constitutional monarchy"]
what kind of money does egypt have?	["Egyptian pound"]
what kind of money do i bring to mexico?	["Mexican peso"]
what kind of money do i need in costa rica?	["Costa Rican colón"]
what kind of money do they use in germany?	["Euro"]
what kind of money should i take to costa rica?	["Costa Rican colón"]
what kind of music did franz liszt compose?	["Opera","Classical music","Romantic music","Art song","Chamber music"]
what kind of music did jimi hendrix play?	["Rock music"]
what kind of painter was wassily kandinsky?	["Abstract art","German Expressionism","Expressionism","Der Blaue Reiter"]
what kind of products does nike sell?	["Athletic Shoes & Apparel"]
what kind of shoes do french people wear?	["jansegers"]
what kind of tennis racquet does serena williams use?	["Yetunde Price"]
what kind of writing is nikolai gogol famous for?	["Dramatist"]
what kourtney kardashian boyfriends name?	["Scott Disick"]
what lands did henry hudson discover?	["Hudson Bay"]
what language brazil speak?	["Brazilian Portuguese","Portuguese Language","Italian Language"]
what language did the ancient babylonians speak?	["Akkadian language"]
what language did the sioux indians speak?	["Sioux language","French Language","English Language"]
what language did they speak in ghana?	["Akan Language"]
what language do australia people speak?	["Lojban","Esperanto Language","English Language"]
what language do bosnian muslims speak?	["Bosnian language"]
what language do brazilians use?	["Pomeranian language","German Language","Portuguese Language","Plautdietsch Language","Hunsrückisch"]
what language do british speak?	["Scottish Gaelic language","Scots Language","Cornish Language","Irish","English Language","Welsh Language","Guernésiais","Ulster Scots dialects","Jèrriais","Manx Language"]
what language do chinese people write in?	["Traditional Chinese characters","Chinese","Simplified Chinese character","'Phags-pa script","Nüshu script","Chinese characters"]
what language do colombian people speak?	["Wiwa language","Uw Cuwa","Andoque language","Spanish Language","Camsá Language","Cogui Language","Guambiano Language","Páez language","Arhuaco Language"]
what language does algerian people speak?	["Northern Berber languages","Numidian language","Arabic Language","Western Berber languages","Proto-Berber language","Guanche Language"]
what language does australians speak?	["Greek Language","English Language","Italian Language","Chinese language"]
what language does australia use?	["English Language"]
what language does colombia?	["Wiwa language","Uw Cuwa","Andoque language","Spanish Language","Camsá Language","Cogui Language","Guambiano Language","Páez language","Arhuaco Language"]
what language does cuba speak?	["Spanish Language"]
what language does east timor speak?	["Tetun Language","Portuguese Language"]
what language does egyptian people speak?	["Modern Standard Arabic"]
what language does iceland speak?	["Icelandic Language"]
what language does people in iceland speak?	["Icelandic Language"]
what language does peru speak?	["Omagua Language","Spanish Language","Waorani Language","Quechua","Puquina Language","Aymara language"]
what language do maltese speak?	["Maltese Language","English Language"]
what language do most australians speak?	["Greek Language","English Language","Italian Language","Chinese language"]
what language do most italians speak?	["Italian Language"]
what language do most people speak in afghanistan?	["Pashto language"]
what language do navajo people speak?	["Spanish Language","Navajo Language","English Language"]
what language do people from bosnia speak?	["Croatian language","Bosnian language","Serbian language"]
what language do people from greece speak?	["Albanian language","Greek Language"]
what language do people from thailand speak?	["Mon Language","Lao Language","Khmer language","Hmong language","Thai Language","Cham language","Mlabri language","Malay, Pattani Language","Nyaw Language","Saek language"]
what language do people from the uk speak?	["Scottish Gaelic language","Scots Language","British Sign Language","Cornish Language","Esperanto Language","English Language","Welsh Language","Irish"]
what language do people speak in brazil?	["Portuguese Language"]
what language do people speak in the bahamas?	["Bahamas Creole English Language","English Language"]
what language do people speak in the netherlands?	["Frisian languages","West Flemish","Dutch Language"]
what language do russians speak?	["Russian Language"]
what language do serbs speak?	["Serbian language"]
what language do speak in argentina?	["Yiddish Language","Italian Language","Spanish Language"]
what language do the cheyenne speak?	["Cheyenne Language","English Language"]
what language do the maasai speak?	["Maasai Language"]
what language do the maasai tribe speak?	["Maasai Language"]
what language do the russian speak?	["Yiddish Language","Chuvash Language","Russian Language","Tatar Language","Ukrainian Language"]
what language do they in ghana?	["English Language"]
what language do they speak in colombia south america?	["Spanish Language"]
what language do they speak in malta?	["Maltese Language","English Language"]
what language do they speak in sweden yahoo?	["Yiddish Language","Meänkieli","Swedish Language","Finnish Language","Romani language"]
what language do they use in pakistan?	["Seraiki Language","Hindustani language","Pashto language","Punjabi language","Brahui Language","Balochi language","English Language","Urdu Language","Sindhi Language","Hindko dialect"]
what language do ukrainian people speak?	["Russian Language","Romanian Language","Ukrainian Language","Albanian language","Hungarian language","Tatar Language","Moldovan language"]
what language group does germany belong to?	["Bavarian Language","German Language","Saxon, Upper Language"]
what language is mainly spoken in egypt?	["Arabic Language"]
what language is most commonly spoken in belgium?	["French Language","German Language","Dutch Language"]
what language is spoken in argentina?	["Spanish Language"]
what language is spoken in greek?	["Greek Language"]
what language is spoken in haiti today?	["French Language","Haitian Creole French Language"]
what language is spoken in switzerland?	["Romansh language","French Language","German Language","Italian Language"]
what languages are there in japan?	["Japanese Language"]
what languages do people speak in spain?	["Spanish Language"]
what languages do they speak in costa rica?	["Spanish Language"]
what language speak in brazil?	["Brazilian Portuguese","Portuguese Language","Italian Language"]
what language they speak in scotland?	["Scottish English"]
what language tunisia?	["French Language","Arabic Language"]
what language turkey people speak?	["Turkish Language"]
what league are the indianapolis colts in?	["AFC South"]
what led to stalin rise in power?	["In 1912, Lenin, who was forced to flee the country, chose him to serve on the first Central Committee of the Bolshevik party, which had now broken from the Social Democrats."]
what led to the split of the republican party in 1912?	["Zachariah Chandler"]
what made richard hammond famous?	["Top Gear"]
what made the soviet union fall?	["Cold War"]
what make of bike did steve mcqueen ride in the great escape?	["Yucatan"]
what makes elvis presley famous?	["Singer"]
what makes the film so popular back in london?	["Cambridge"]
what materials did eduardo paolozzi use in his work?	["Sculpture"]
what money does cuba use?	["Cuban peso","Cuban convertible peso"]
what money does spain use?	["Euro"]
what money do i use in costa rica?	["Costa Rican colón"]
what money do they use in spain?	["Euro"]
what money to take to turkey?	["Turkish lira"]
what movies did christopher plummer play in?	["The Girl with the Dragon Tattoo","Gandahar","My Dog Tulip","Up","The Imaginarium of Dr. Parnassus","Beginners","Priest","Five Good Years","9","The Last Station"]
what movies did david carradine play in?	["Kill Bill Volume 2","Bound for Glory","North and South","Kung Fu"]
what movies did joan crawford play in?	["Children’s Hospital Los Angeles"]
what movies did morgan freeman star in?	["10 Items or Less","Batman Begins","All About Us","A Raisin in the Sun","Bruce Almighty","Amistad","Brubaker","An Unfinished Life","A Man Called Adam","Along Came a Spider"]
what movies did nick cannon star in?	["A Very School Gyrls Holla-Day","Bobby","Day of the Dead","Even Money","Goal II: Living the Dream","American Son","Weapons","Ball Don't Lie","The Killing Room","Monster House"]
what movies did ron howard director?	["How the Grinch Stole Christmas!"]
what movies did tupac star in?	["Nothing but Trouble"]
what movies does logan lerman play in?	["The Only Living Boy in New York","Stuck in Love","The Perks of Being a Wallflower","The Three Musketeers","The Butterfly Effect","The Number 23","The Patriot","The Scribe","Riding in Cars with Boys","What Women Want"]
what movies does matt dallas play in?	["The Story of Bonnie and Clyde","Babysitter Wanted","Hot Dudes with Kittens","Beauty & the Briefcase","In Between Days","The Indian","As Good as Dead","Living the Dream","Camp Slaughter","Wyatt Earp's Revenge"]
what movies does nick cannon play in?	["A Very School Gyrls Holla-Day","Bobby","Day of the Dead","Even Money","Goal II: Living the Dream","American Son","Weapons","Ball Don't Lie","The Killing Room","Monster House"]
what movies gerard butler has been in?	["Attila","Beowulf & Grendel","300","Dear Frankie","Butterfly on a Wheel","Gamer","Fast Food","Dracula 2000","Coriolanus"]
what movies has carmen electra been in?	["The Mating Habits of the Earthbound Human","Scary Movie","Getting Played","Cheaper by the Dozen 2","Meet the Spartans","I Want Candy","Full of It","The Chosen One: Legend of the Raven","Scary Movie 4","Dirty Love"]
what movies has john williams score?	["A.I. Artificial Intelligence","Always","Catch Me If You Can","1941","Daddy-O","Amistad","Close Encounters of the Third Kind","E.T. the Extra-Terrestrial","Empire of the Sun","Earthquake"]
what movies has liam hemsworth played in?	["Knowing","Triangle","The Hunger Games","The Expendables 2","The Last Song","Timeless","Empire State","The Hunger Games: Catching Fire","Arabian Nights","Love and Honor"]
what movies has miley cyrus been in?	["Hannah Montana: The Movie","Super Rhino","Sonic the Hedgehog","LOL: Laughing Out Loud","Big Fish","Sex and the City 2","Bolt","The Last Song","So Undercover","High School Musical 2"]
what movies has spike lee made?	["Jungle Fever","Inside Man","He Got Game","Clockers","Bamboozled","25th Hour","Girl 6","Get on the Bus","Crooklyn","Do the Right Thing"]
what movies have robert pattinson in them?	["Eclipse","Dark Kingdom: The Dragon King","New Moon","Remember Me","How to Be","Harry Potter and the Order of the Phoenix","Little Ashes","Bel Ami","Twilight","The Twilight Saga: Breaking Dawn - Part 1"]
what movies is omar epps in?	["Daybreak","Major League II","Scream 2","First Time Felon","Breakfast of Champions","Juice","The Program","Deadly Voyage","Higher Learning","Don't Be a Menace to South Central While Drinking Your Juice in the Hood"]
what movies queen latifah is in?	["Taxi","Jungle Fever","Set It Off","Stranger than Fiction","Last Holiday","Brown Sugar","Ice Age: The Meltdown","Ice Age: Dawn of the Dinosaurs","Hairspray","Bringing Down the House"]
what musical instruments does justin bieber play?	["guitar","Piano","trumpet","Drums"]
what music did louis armstrong play?	["Jazz"]
what music period did beethoven live in?	["Opera","Classical music"]
what nationality is mother teresa?	["India"]
what nationality is rihanna?	["Barbados"]
what nationality is taylor lautner jacob black?	["United States of America"]
what national team does cristiano ronaldo play for?	["Portugal national football team"]
what new movies is robert pattinson in?	["Eclipse","Dark Kingdom: The Dragon King","New Moon","Remember Me","How to Be","Harry Potter and the Order of the Phoenix","Little Ashes","Bel Ami","Twilight","The Twilight Saga: Breaking Dawn - Part 1"]
what objects did galileo see with his telescope?	["Ganymede","Callisto","Europa","Galilean moons","Io"]
what ocean is around hawaii?	["Pacific Ocean"]
what offices did theodore roosevelt hold?	["President","Governor","Vice President"]
what other books did charles dickens write?	["The Chimes","Our Mutual Friend","The Old Curiosity Shop","David Copperfield","A Christmas Carol","The Cricket on the Hearth","The Life and Adventures of Nicholas Nickleby","Hard Times","Oliver Twist","A Tale of Two Cities"]
what other books did louis sachar write?	["Dogs Don't Tell Jokes","Holes","Someday Angeline","Sideways Arithmetic From Wayside School","Wayside School Gets A Little Stranger","Sideways Stories From Wayside School","Small Steps","Stanley Yelnats' Survival Guide to Camp Green Lake","Sixth Grade Secrets","The Boy Who Lost His Face"]
what other countries border argentina?	["Brazil","Paraguay","Bolivia","Chile"]
what other countries does south africa share borders with?	["Lesotho","Zimbabwe","Mozambique","Swaziland","Namibia","Botswana"]
what other movies has ryan gosling been in?	["The United States of Leland","Half Nelson","The Slaughter Rule","Stay","Lars and the Real Girl","The Believer","Fracture","Murder by Numbers","The Notebook","All Good Things"]
what other movies has tom hardy played in?	["Warrior","Mad Max: Fury Road","Thick as Thieves","Lawless","This Means War","Tinker, Tailor, Soldier, Spy","Bronson","The Dark Knight Rises","Inception","Sergeant Slaughter, My Big Brother"]
what other movies is josh hutcherson in?	["The Hunger Games","Bridge to Terabithia","The Kids Are All Right"]
what other organisms did mendel use in experiments?	["Experiments in plant hybridisation"]
what other states border florida?	["Alabama","Georgia"]
what part did jeff conaway play in grease?	["Kenickie Murdoch"]
what part did winona ryder play in star trek?	["Amanda Grayson"]
what part of the country is new england?	["Northeastern United States"]
what part of the country is ohio considered?	["Midwestern United States"]
what part of the country is ohio in?	["Midwestern United States"]
what party does barack obama belong to?	["Democratic Party"]
what party was abe lincoln part of?	["Illinois Republican Party","Republican Party","National Union Party","Whig Party"]
what party was thomas jefferson affiliated with?	["Democratic-Republican Party"]
what percentage of cases does the us supreme court take?	["United States of America"]
what percent of americans have college degree?	["Why Race Mattered in Barack Obama's Re-election"]
what percent of people are overweight in the uk?	["uk"]
what pieces of music did claude debussy compose?	["Cello Sonata","La chute de la maison Usher","L'enfant prodigue","Prélude à l'après-midi d'un faune","Jeux","String Quartet","Le martyre de Saint Sébastien","Le diable dans le beffroi","Rodrigue et Chimène","Pelléas et Mélisande"]
what places are in the west midlands?	["Metropolitan Borough of Solihull","Sandwell","Turners Hill, West Midlands","Walsall","Coventry","Allesley","Metropolitan Borough of Walsall","Barr Beacon","West Bromwich","Metropolitan Borough of Dudley"]
what places in japan were bombed?	["Hiroshima Prefecture"]
what places make up new england?	["Maine"]
what planet did luke skywalker came from?	["Polis Massa"]
what political party did andrew johnson belong to?	["Democratic Party","National Union Party","Republican Party"]
what political party does barack obama represent?	["Democratic Party"]
what political party does julia gillard belong to?	["Queensland Labor Party","Australian Labor Party"]
what political party is jerry brown?	["Democratic Party","California Democratic Party"]
what political party was hitler in?	["German Workers' Party","Nazi Party"]
what political system did spain have?	["Parliamentary system","Unitary state","Constitutional monarchy","Multi-party system"]
what position did lebron james play?	["Point forward","Small forward"]
what position did stanley matthews play?	["Midfielder","Outside forward"]
what position did vince lombardi play in college?	["Right Guard"]
what position did vince lombardi play?	["Right Guard"]
what position does brandon roy play?	["Point guard","Small forward","Shooting guard"]
what produce does florida export?	["Orange juice"]
what products and\/or services does google offer customers?	["Google Maps","Google Calendar","Google SketchUp","Google Docs and Spreadsheets","Blogger","Picasa","Google Talk","Google X","Gmail"]
what products does the united states export?	["Pharmaceutical Preparations","Food","Industrial Organic Chemicals, NEC","Automobile"]
what prompted shakespeare to write poetry?	["Thomas More","Ovid","Geoffrey Chaucer","Plutarch","Terence","Thomas Kyd","Plautus","Michel de Montaigne","John Pory","Christopher Marlowe"]
what province is montreal canada located?	["Québec"]
what province is toronto in ( 7 letters )?	["Ontario"]
what race is vanessa carlton?	["Russian","Scandinavians"]
what radio station is npr on in nyc?	["WNYC"]
what rainforest is in south america?	["Amazon Basin"]
what record label is kelly clarkson signed with?	["RCA Records","Sony BMG Music Entertainment","Sony Music Entertainment"]
what region did the incas live in?	["Cusco"]
what region is turkey considered?	["Southeastern Anatolia Region","Central Anatolia Region","Mediterranean Region, Turkey","Black Sea Region","Eastern Anatolia Region","Marmara Region","Aegean Region"]
what region of the world is egypt associated with?	["Middle East"]
what religion did adolf hitler follow?	["Catholicism","Christianity"]
what religion does canada follow?	["Protestantism","Catholicism","Islam"]
what religion does madonna practice?	["Catholicism","Jewish Renewal"]
what religions are popular in france?	["Catholicism"]
what religion was king louis xiv?	["Catholicism"]
what rihanna new album called 2012?	["Unapologetic"]
what role did alexander hamilton play in the constitution?	["Financier"]
what role did george lucas play in star wars?	["Film Director"]
what role did paul mccartney play in the beatles?	["Backing vocalist","bass","Lead vocalist"]
what russian language called?	["Yiddish Language","Chuvash Language","Russian Language","Tatar Language","Ukrainian Language"]
what sarah dessen books are movies?	["The Truth About Forever"]
what school did ben roethlisberger go to?	["Miami University"]
what school did douglas macarthur go to?	["TMI — The Episcopal School of Texas"]
what school did john henry thompson go to?	["Victoria University of Manchester","University of Manchester","University of Cambridge"]
what school did karl benz go to?	["Karlsruhe Institute of Technology","University of Karlsruhe"]
what school did mark zuckerberg attend?	["Mercy College","Phillips Exeter Academy","Harvard University","Ardsley High School"]
what school did martin luther king jr received his doctorate degree from?	["Boston University"]
what school did michael jackson go to high school?	["Montclair College Preparatory School"]
what school did michael jordan attend?	["University of North Carolina at Chapel Hill","Emsley A. Laney High School"]
what school did miley cyrus?	["Heritage Elementary School"]
what school did robert f kennedy go to?	["Bates College","Milton Academy","University of Virginia School of Law","University of Virginia","Harvard University","Harvard College"]
what school did sir ernest rutherford go to?	["Trinity College, Cambridge","Nelson College","University of Canterbury","University of Cambridge","University of New Zealand"]
what school did wilfred owen go to?	["University of London","University of Reading"]
what school does james franco go to?	["Yale University"]
what schools did anders celsius attend?	["Uppsala University"]
what schools did sir isaac newton go to?	["The King's School, Grantham","Trinity College, Cambridge"]
what season did lana lang leave smallville?	["Smallville - Season 8"]
what ship did darwin sail around the world?	["HMS Beagle"]
what should i do today in san francisco?	["Golden Gate Park"]
what shows are shot in new york?	["Flight of the Conchords","The Stand"]
what's my timezone in oklahoma?	["Central Time Zone"]
what songs did franz liszt compose?	["La lugubre gondola","Piano Concerto No. 1","Sonata in B minor","Piano Concerto No. 3","Piano Concerto No. 2","Dante Symphony","Concerto pathetique","Don Sanche","Transcendental Études","Faust Symphony"]
what songs does smokey robinson sing?	["Being With You","Cruisin'","Crusin'","And I Love Her","The Tracks of My Tears","Quiet Storm","Tracks of my Tears","Santa Claus is Coming to Town"]
what songs do zac brown band sing?	["As She's Walking Away","You Get What You Give","Free","The Foundation","Chicken Fried"]
what sort of government does nigeria have?	["Federal republic"]
what spain brought to the new world?	["Spanish Language"]
what sport is popular in italy?	["Italy women's national football team","Italy women's national volleyball team","Italy Fed Cup team","Italy national cricket team","Italy Davis Cup team","Italy men's national volleyball team","A1 Team Italy","Italy women's national beach handball team","Italy national futsal team","Italy national football team"]
what sports are popular in germany?	["Germany women's national volleyball team","Germany national cricket team","Germany national badminton team","Germany national football team","A1 Team Germany","Germany Davis Cup team","Germany Fed Cup team","Germany women's national basketball team","Germany national basketball team","Germany men's national volleyball team"]
what sports do people play in poland?	["Poland national football team","Poland national handball team","Poland women's national volleyball team","Poland men's national volleyball team","Poland women's national handball team"]
what sri lanka capital?	["Sri Jayawardenapura Kotte"]
what standard time is michigan?	["Central Time Zone","North American Eastern Time Zone","UTC-5"]
what standard time is texas?	["Central Time Zone"]
what state did john adams live in?	["Massachusetts"]
what state does romney live in?	["Massachusetts"]
what state is barack obama from?	["Hawaii"]
what state is mount st. helens in?	["Washington"]
what state is saint louis university in?	["Missouri"]
what state is the steelers from?	["Pittsburgh"]
what state is washington d.c. located?	["Washington","Washington, D.C."]
what state new york city belong to?	["New York"]
what states does the sierra nevada run through?	["Nevada","California"]
what states make up the midwest us?	["Wisconsin","North Dakota","Kansas","Council Grove","Nebraska","Indiana","Ohio"]
what states share a border with tennessee?	["Virginia"]
what's there to see in atlanta?	["Atlanta History Center","Atlanta Cyclorama & Civil War Museum","Atlanta Ballet","Fernbank Museum of Natural History","Woodruff Arts Center","Zoo Atlanta","Atlanta Symphony Orchestra","Centennial Olympic Park","Martin Luther King, Jr., National Historic Site","Fernbank Science Center"]
what stones albums did mick taylor play on?	["A Stone's Throw","Too Hot For Snakes","Stranger in This Town","Little Red Rooster","Arthur's Club-Geneve 1995","Keepin It Real","Mick Taylor"]
what style of art did henri matisse do?	["Impressionism"]
what style of music did bessie smith perform?	["Blues","Jazz"]
what style of music does john mayer play?	["Soul music","Pop rock","Pop music","Indie rock","Blues-rock","Blue-eyed soul","Soul rock","Rock music","Blues","Acoustic music"]
what style of music does michael jackson perform?	["Pop music"]
what super bowl did peyton manning win?	["2006 NFL season"]
what superbowl did the baltimore ravens win?	["Super Bowl XXXV","Super Bowl XLVII"]
what system of government does guyana have?	["Semi-presidential system","Republic","Unitary state"]
what system of government is practiced in nigeria?	["Federal republic"]
what team did adrian peterson play for in college?	["University of Oklahoma"]
what team did aguero play for?	["Argentina national football team","Manchester City F.C.","Club Atlético Independiente","Atlético Madrid"]
what team did brandon roy go to?	["Minnesota Timberwolves"]
what team did david beckham play for before la galaxy?	["Preston North End F.C."]
what team did david beckham play for in 2011?	["LA Galaxy"]
what team did drogba play for?	["Galatasaray S.K."]
what team did howie long?	["Villanova Wildcats football","Oakland Raiders"]
what team did jackie robinson?	["Montreal Royals","Kansas City Monarchs","Los Angeles Bulldogs","Brooklyn Dodgers","UCLA Bruins football"]
what team did jeremy lin go to?	["Houston Rockets"]
what team did messi play for in 2010?	["Argentina national football team"]
what team did monta ellis get traded to?	["Milwaukee Bucks"]
what team did peyton manning's dad play for?	["New Orleans"]
what team did ronaldo play for in 2003?	["Real Madrid C.F."]
what team does colin kaepernick play for?	["San Francisco 49ers"]
what team does cristiano ronaldo play for 2011?	["Real Madrid C.F."]
what team does david beckham play for in 2012?	["LA Galaxy"]
what team does heskey play for?	["Newcastle Jets FC"]
what team does jeremy lin play for 2013?	["Houston Rockets"]
what team does jordan own?	["Jordan national football team"]
what team does josh hamilton play for?	["Texas Rangers","Los Angeles Angels of Anaheim"]
what team does messi play for 2011?	["FC Barcelona"]
what team does mike fisher play for?	["Nashville Predators"]
what team is cristiano ronaldo play for?	["Real Madrid C.F."]
what team is hank baskett on 2010?	["Philadelphia Eagles"]
what team is kris humphries play for?	["Brooklyn Nets"]
what team is raul ibanez on?	["Seattle Mariners"]
what team is reggie bush on 2011?	["New Orleans Saints"]
what teams has manny ramirez played for?	["Boston Red Sox","Los Angeles Dodgers","Cleveland Indians"]
what team was chris paul on?	["Los Angeles Clippers"]
what team will michael vick play for in 2011?	["Philadelphia Eagles"]
what the language spoken in indonesia?	["Javanese Language","Malay Language","Sunda Language","English Language","Bali Language","Indonesian Language","Batak Language","Tobelo Language","Dutch Language","Madura Language"]
what the largest city in spain?	["Madrid"]
what there to do in salt lake city utah?	["Salt Lake Golden Eagles","Salt Lake City Gulls","Utah Utes men's basketball","Salt Lake City Angels","Utah Grizzlies","Real Salt Lake","Utah Jazz"]
what the time zone in england?	["Greenwich Mean Time","UTC±00:00"]
what the time zone in japan?	["Japan Standard Time","UTC+09:00"]
what the zip code for seattle washington?	["98109","98108","98105","98104","98107","98106","98101","98103","98102","98117"]
what things did martin luther king do?	["Civil rights movement","Civil disobedience","Nonviolence"]
what time does american horror story air?	["Tom Selleck"]
what time does registration open portland state?	["Zora Lancaster"]
what time in china hong kong?	["UTC+8"]
what time in hilo hawaii?	["Hawaii–Aleutian Time Zone"]
what time is it in texas houston right now?	["Central Time Zone"]
what time zone am i in california?	["Pacific Time Zone","UTC-8"]
what time zone is anaheim california?	["Pacific Time Zone"]
what time zone is chicago in right now?	["Central Time Zone"]
what timezone is elizabethtown kentucky?	["North American Eastern Time Zone"]
what time zone is greensburg indiana?	["North American Eastern Time Zone"]
what time zone is in the bahamas?	["UTC-5","North American Eastern Time Zone"]
what timezone is nashville tn?	["Central Time Zone"]
what time zone is pennsylvania in right now?	["UTC-5","North American Eastern Time Zone"]
what timezone is phoenix az in right now?	["Mountain Time Zone"]
what timezone is sweden?	["Central European Time"]
what timezone is sweden gmt?	["Central European Time","UTC+01:00"]
what timezone is the state of michigan and?	["Central Time Zone","North American Eastern Time Zone","UTC-5"]
what time zone is toronto gmt?	["North American Eastern Time Zone"]
what timezone is tucson arizona in right now?	["Mountain Time Zone"]
what timezone is utah in?	["Mountain Time Zone"]
what to do and see in vienna austria?	["Belvedere, Vienna","Hofburg Palace","Prater","St. Peter's Church","St. Stephen's Cathedral, Vienna","Schönbrunn Palace","Jesuit Church, Vienna","Karlskirche, Vienna","Rathaus, Vienna","Minoritenkirche, Vienna"]
what to do downtown sacramento?	["Zac Hill"]
what to do for fun in houston?	["George R. Brown Convention Center","Sam Houston Race Park","Rothko Chapel","Kemah Boardwalk","Space Center Houston","Downtown Aquarium, Houston","Hanna–Barbera Land","Bayou Bend","SplashTown Houston","Houston Zoo"]
what to do in bangkok in 4 days?	["MRT Blue Line","Wat Benchamabophit","Grand Palace","Ananta Samakhom Throne Hall","Wat Saket","Khaosan Road","Bangkok National Museum","Samutprakarn Crocodile Farm and Zoo","Wat Pho","Wat Arun"]
what to do in cancun during spring break?	["Belize Barrier Reef","Ik Kil","Isla Contoy","Xcaret Park","Chichen Itza","Xel-Ha Park","Sistema Dos Ojos","Coba","Delphinus Dreams","Cancun Underwater Museum"]
what to do in hollywood ca this weekend?	["Griffith Observatory","Grauman's Egyptian Theatre","TCL Chinese Theatre","Universal Studios Hollywood","Hollywood Walk of Fame","Hollywood Sign","Hollywood Heritage Museum","Hollywood Wax Museum","Dolby Theatre","Universal CityWalk"]
what to do in paris in 1 day?	["Musée Maillol","Palace of Versailles","Eiffel Tower","Île de la Cité","Café Volpini","Notre Dame de Paris","Folies Bergère","Arc de Triomphe","Basilica of the Sacré Cœur","Panthéon, Paris"]
what to do in richardson dallas?	["Wizard's Sports Cafe"]
what to do in rome october 2012?	["Sistine Chapel","Piazza Navona","Roman Forum","Baths of Caracalla","Castel Sant'Angelo","Bocca della Verità","Pantheon","St. Peter's Basilica","Raphael Rooms","Colosseum"]
what to do san jose ca?	["San Jose Municipal Rose Garden","The Tech Museum of Innovation","Winchester Mystery House","Japantown","Downtown San Jose","Rosicrucian Egyptian Museum","San Jose Museum of Quilts & Textiles","San Jose Museum of Art","Alum Rock Park","Santana Row"]
what to do this weekend in manchester with kids?	["Urbis","Imperial War Museum North","Wheel of Manchester","Manchester Art Gallery","Old Trafford","Manchester Museum","Whitworth Art Gallery","Manchester Jewish Museum","Manchester Cathedral","Chinatown, Manchester"]
what to do today in atlanta with kids?	["Atlanta History Center","Atlanta Cyclorama & Civil War Museum","Atlanta Ballet","Fernbank Museum of Natural History","Woodruff Arts Center","Zoo Atlanta","Atlanta Symphony Orchestra","Centennial Olympic Park","Martin Luther King, Jr., National Historic Site","Fernbank Science Center"]
what to do with kids in asheville nc?	["Asheville Aces","Asheville Smoke"]
what to do with kids in essex?	["RHS Garden, Hyde Hall","Mountfitchet Castle","Marsh Farm Country Park","Thorndon Country Park","Green Island Gardens","Mistley Place Park","Beth Chatto Gardens","Colchester Zoo","Waltham Abbey Royal Gunpowder Mills","Cudmore Grove Country Park"]
what to do with kids in summer in dubai?	["Mushrif Park","Dubai Zoo","Fish Roundabout","Jumeirah Beach","Dubai International Convention Centre","Grand mosque","The Dubai Mall","Wild Wadi Water Park","Dubai Museum","Deira Clocktower"]
what to do with my kids in toronto?	["Edwards Gardens","Black Creek Pioneer Village","Distillery District","CN Tower","Art Gallery of Ontario","Chinatown, Toronto","BMO Field","Bata Shoe Museum","Air Canada Centre","Cabbagetown, Toronto"]
what to see and do in vancouver washington?	["Slocum House","Fort Vancouver","Fort Vancouver Barracks Officers Row","Fort Vancouver National Historic Site","Vancouver National Historic Reserve Historic District","Officers Row","House of Providence","Covington House","Evergreen Hotel","Hidden Houses"]
what to see in christchurch new zealand?	["Lincoln","Christchurch Botanic Gardens","Avon River","Merivale","Rochester and Rutherford Hall","Al-Huda Islamic Charitable Trust - HICT","Orana Wildlife Park","Hagley Park","Lancaster Park","Queen Elizabeth II Park"]
what to see in montreal downtown?	["Casino de Montréal","Parc Jean-Drapeau","La Ronde","Canadian Centre for Architecture","Montreal Botanical Garden","Maisonneuve Park","La Fontaine Park","Mount Royal","Old City","Musée d'art contemporain de Montréal"]
what to see in phoenix arizona?	["Grand Canyon","Phoenix Mountain Preserve","Phoenix Art Museum","Desert Botanical Garden","Heard Museum","Musical Instrument Museum","Arizona Science Center","Ro Ho En","Mesa Arts Center","Pueblo Grande Ruin"]
what to see in toronto top 10?	["Edwards Gardens","Black Creek Pioneer Village","Distillery District","CN Tower","Art Gallery of Ontario","Chinatown, Toronto","BMO Field","Bata Shoe Museum","Air Canada Centre","Cabbagetown, Toronto"]
what to see near grand canyon?	["Grand Canyon National Park Superintendent's Residence","Grand Canyon South Rim Ranger's Dormitory","Grand Canyon Village Historic District","Grand Canyon North Rim Headquarters","Grandview Mine","Grand Canyon Water Reclamation Plant","Buckey O'Neill Cabin","El Tovar Hotel","Grand Canyon Depot"]
what to visit in atlanta?	["Philips Arena","Georgia Dome","Omni Coliseum","Zoo Atlanta","Grant Park","Castleberry Hill","Atlanta-Fulton County Stadium","Little Five Points","Turner Field","Buckhead"]
what to visit in denver?	["Black American West Museum & Heritage Center","Denver Firefighters Museum","Colorado State Capitol","Denver Mint","Molly Brown House","Forney Transportation Museum","Denver Botanic Gardens","Museum of Contemporary Art Denver","Denver Museum of Nature and Science","Chamberlin Observatory"]
what to visit in london city?	["Regent's Park","Tower of London","Buckingham Palace","Palace of Westminster","London Eye","Tower Bridge","Hyde Park","Westminster Abbey","St Paul's Cathedral","Trafalgar Square"]
what town did justin bieber grew up in?	["London"]
what town was martin luther king assassinated in?	["Memphis"]
what tv series did mark harmon star in?	["NCIS","Centennial","Flamingo Road","The Dream Merchants","Reasonable Doubts","240-Robert","Chicago Hope","St. Elsewhere","From the Earth to the Moon","Charlie Grace"]
what tv shows did shawnee smith play in?	["Anger Management","The Tom Show","Scream Queens","Brand New Life","30 Days of Night: Dust to Dust","Arsenio","Becker","The Stand","All is Forgiven"]
what two continents is turkey on?	["Europe","Eurasia","Asia"]
what two countries make up the dominican republic?	["Hispaniola"]
what two states is st louis in?	["Missouri"]
what type government does mexico have?	["Federal government of Mexico"]
what type of art did leonardo da vinci make?	["Sculpture","Painting","Drawing"]
what type of art did pablo picasso paint?	["Cubism","Analytic cubism","African Period","Picasso's Blue Period","Italian modern and contemporary art","Synthetic cubism","Picasso's Rose Period"]
what type of art did raphael sanzio create?	["Painting","Drawing"]
what type of art does claude monet do?	["Impressionism"]
what type of art does marc chagall do?	["Surrealism","Expressionism"]
what type of artist is henri matisse?	["Sculpture","Printmaking","Collage","Painting","Drawing"]
what type of art leonardo da vinci do?	["Sculpture","Painting","Drawing"]
what type of books did agatha christie wrote?	["Crime writer"]
what type of breast cancer did sheryl crow have?	["Meningioma"]
what type of cancer did eva peron die from?	["Cervical cancer"]
what type of cancer did eva peron have?	["Cervical cancer"]
what type of cancer did gilda radner die of?	["Ovarian cancer"]
what type of cancer did larry hagman have?	["Head and neck cancer","Cancer","Leukemia"]
what type of currency do they use in england?	["UK £"]
what type of currency do they use in spain?	["Euro"]
what type of currency do they use in thailand?	["Thai baht"]
what type of democracy is the united states?	["Federal republic"]
what type of drugs did whitney houston?	["Cocaine overdose"]
what type of economy exists in china?	["Socialist state"]
what type of equipment did dorothea lange use?	["Photography"]
what type of government did mexico have?	["Federal republic"]
what type of government did soviet union have?	["Communist state"]
what type of government did thomas jefferson prefer?	["Unitarianism"]
what type of government does argentina have today?	["Representative democracy","Presidential system","Federal republic","Federation"]
what type of government does australia have?	["Parliamentary system","Federation","Constitutional monarchy"]
what type of government does brazil have 2011?	["Brazilian Labour Renewal Party"]
what type of government does france use?	["Semi-presidential system","Constitutional republic","Unitary state"]
what type of government does germany have now?	["Constitutional republic","Multi-party system","Federal republic","Democracy","Parliamentary republic"]
what type of government does iraq have now?	["Parliamentary system","Federation","Republic","Federal republic","Parliamentary republic"]
what type of government does italy have 2011?	["Parliamentary republic"]
what type of government does russia have 2010?	["Semi-presidential system","Constitutional republic","Republic","Federation"]
what type of government does the us constitution set up?	["Presidential system","Federal republic","Representative democracy","Two-party system","Constitutional republic","Republic"]
what type of government does the us follow?	["Presidential system","Federal republic","Representative democracy","Two-party system","Constitutional republic","Republic"]
what type of government does usa follow?	["Federal republic"]
what type of government japan have?	["Parliamentary system","Unitary state","Constitutional monarchy"]
what type of government system does italy have?	["Constitutional republic","Parliamentary republic","Unitary state"]
what type of government was formed when italy unified?	["Parliamentary republic"]
what type of government was utilized in ancient egypt?	["House of Representatives","Parliament of Egypt","Shura Council"]
what type of guitar does johnny depp play?	["Gibson's"]
what type of money do they use in costa rica?	["Costa Rican colón"]
what type of money to take to cuba?	["Cuban peso"]
what type of music did antonio vivaldi play?	["Baroque music","Classical music"]
what type of music did claude debussy play?	["Ballet","French opera","Art song","Incidental music","Classical music","20th-century classical music"]
what type of music did john lennon sing?	["Experimental rock","Pop rock","Pop music","Blues-rock","Art rock","Soft rock","Psychedelic rock","Rock music","Experimental music"]
what type of music did mozart composed?	["Opera","Classical music","Ballet","Art song","Chamber music"]
what type of music did vivaldi compose?	["Baroque music"]
what type of political system is brazil?	["Constitutional republic","Presidential system","Federal republic"]
what type of religion did massachusetts have?	["Judaism","Churches of Christ","Catholicism","United Church of Christ","Episcopal Church","Christianity","Buddhism","Baptists","Lutheranism","Jehovah's Witnesses"]
what type of religion does argentina have?	["Protestantism","Catholicism","Judaism"]
what type of religions are in the united states?	["Unitarian Universalism","Judaism","Christianity","Atheism","Buddhism","Hinduism","Islam"]
what type of sports do japanese play?	["Japan national football team","Japan women's national handball team","Japan men's national volleyball team","Japan national handball team","Japan women's national volleyball team","Japan national baseball team"]
what types of art did andy warhol do?	["Pop art"]
what university did gordon brown attend?	["University of Edinburgh"]
what university did obama graduated from?	["Columbia University"]
what university did romney graduated from?	["Stanford University","Cranbrook Schools","Harvard Law School","Harvard Business School","Harvard University","Brigham Young University"]
what vegetables can i plant in november in southern california?	["Olallieberry","Apple","Phoenix dactylifera","Common Fig","Apricot","Lemon","Grapefruit","Cherry","Grape","Boysenberry"]
what victory was andrew jackson most famous for?	["Battle of Horseshoe Bend","Second Seminole War","Battle of Talladega","War of 1812","Battles of Emuckfaw and Enotachopo Creek","Battle of New Orleans","Napoleonic Wars","Creek War","Battle of Pensacola"]
what voices does seth macfarlane play on family guy?	["Peter Griffin","Mickey McFinnegan","Stewie Griffin","Jake Tucker","Glenn Quagmire","Carter Pewterschmidt","Stan Smith","Tom Tucker","Kevin Swanson","Brian Griffin"]
what war did hitler lose?	["World War II"]
what war did the us lose the most soldiers?	["Vietnam War"]
what wars did robert e lee served in?	["Mexican–American War","American Civil War","Battle of Chancellorsville"]
what was antoni gaudi inspired by?	["William Morris","Eugène Viollet-le-Duc"]
what was augustus caesar famous for?	["Roman emperor","Politician"]
what was benedict arnold most famous for?	["Traitor"]
what was bonnie prince charlie full name?	["Charles Edward Stuart"]
what was dr seuss education?	["Dartmouth College","University of Oxford","Lincoln College, Oxford"]
what was dr seuss real name?	["Theodor Robert Geisel"]
what was dr seuss's real name?	["Theodor Robert Geisel"]
what was firefox programmed in?	["XUL","XBL","JavaScript","C++","Cascading Style Sheets"]
what was francis bacon contributions?	["Scientific method"]
what was franklin d roosevelt's job before president?	["Governor of New York"]
what was franklin pierce famous for?	["President of the United States"]
what was f. scott fitzgerald?	["Poet","Novelist","Writer"]
what was george washington's legacy?	["Founding father"]
what was goebbels role?	["After Hitler's coup in 1933, Goebbels was named Reich"]
what was gregor mendel contribution?	["Mendelian inheritance"]
what was herbert hoover best known for?	["President of the United States"]
what was hitler the leader of?	["Nazi Germany"]
what was james garfield most known for?	["United States Representative","President of the United States"]
what was jesse james killed with?	["Assassination","Firearm"]
what was jesse owens education?	["Ohio State University"]
what was john deere famous for?	["Agricultural machinery"]
what was john quincy adams famous for?	["Secretary of State","President","Ambassador","Member of Congress","Senator"]
what was john tyler?	["President of the United States"]
what was kim richards in?	["The Car","Escape to Witch Mountain","Tuff Turf","Black Snake Moan","Race to Witch Mountain","Devil Dog: The Hound of Hell","No Deposit, No Return","Return from Witch Mountain","Meatballs Part II"]
what was laura ingalls wilder famous for?	["Writer","Author"]
what was lebron james first team?	["Cleveland Cavaliers"]
what was lil wayne's first hit song?	["Go DJ","Ludacris Diss","Freestyle","California Love","Shorty Bounce","Way of Life"]
what was lucille ball?	["Singer","Model","Comedian","Television Producer","Actor"]
what was napoleon bonaparte accomplishments?	["Battle of Landshut","Battle of Teugen-Hausen","Battle of Bassano","Second Battle of Dego","Battle of Mondovi","Battle of Montenotte","Battle of Mount Tabor","Battle of Castiglione","Battle of Waterloo","Battle of Rovereto"]
what was nikola tesla inventions?	["Tesla coil"]
what was nikola tesla known for?	["Inventor"]
what was obama's former occupation?	["Illinois State Senator"]
what was pink floyd's first album?	["The Piper at the Gates of Dawn"]
what was queen elizabeth ii childhood nickname?	["Lillibet"]
what was robert burns famous for?	["Poet"]
what was robert burns?	["Poet","Writer","Bard","Author"]
what was scottie pippen good at?	["Basketball"]
what was scottie pippen known for?	["Basketball player"]
what was shakespeare's wife called?	["Anne Hathaway"]
what was sir isaac newton's inventions?	["Reflecting telescope"]
what was the ancient chinese writing system?	["Sino-Tibetan languages"]
what was the ancient egyptians spoken language?	["Egyptian Arabic"]
what was the book written by charles darwin?	["The Structure and Distribution of Coral Reefs","On evolution","A student's introduction to Charles Darwin","Climbing Plants","The Expression of the Emotions in Man and Animals","The origin of species : complete and fully illustrated","The Origin of Species","The Life of Erasmus Darwin","The Autobiography of Charles Darwin","The Descent of Man, and Selection in Relation to Sex"]
what was the capital city of the east roman empire?	["Constantinople"]
what was the cause of death for bruce lee?	["Cerebral edema"]
what was the cause of death for huell howser?	["Prostate cancer"]
what was the cause of death for laci peterson?	["Murder"]
what was the currency used in france before the euro?	["French franc","Assignat"]
what was the first book charles dickens wrote?	["Oliver Twist"]
what was the first language spoken in spain?	["Spanish Language"]
what was the government like in virginia colony?	["Government of Virginia"]
what was the japanese war called?	["World War II"]
what was the last movie sean connery was in?	["Sir Billi"]
what was the name of benjamin franklin wife?	["Deborah Read"]
what was the name of henry viii first wife?	["Catherine of Aragon"]
what was the name of jfk's brothers?	["Robert F. Kennedy","Ted Kennedy","Rosemary Kennedy","Kathleen Cavendish","Patricia Kennedy Lawford","Jean Kennedy Smith","Eunice Kennedy Shriver","Joseph P. Kennedy, Jr."]
what was the title of the book charles darwin wrote?	["The Structure and Distribution of Coral Reefs","On evolution","A student's introduction to Charles Darwin","Climbing Plants","The Expression of the Emotions in Man and Animals","The origin of species : complete and fully illustrated","The Origin of Species","The Life of Erasmus Darwin","The Autobiography of Charles Darwin","The Descent of Man, and Selection in Relation to Sex"]
what was thomas jefferson role in the declaration of independence?	["Writer"]
what was tycho brahe theory?	["Brahe's astronomical investigations began to suggest that the existing literature on the solar system was inaccurate."]
what was van halen first album?	["Van Halen"]
what was wayne gretzky's first team?	["Edmonton Oilers"]
what were amelia earhart's achievements?	["Writer","Pilot"]
what were the names of henry viii's three children?	["Prince Henry, Duke of Cornwall","Edward VI of England","Mary I of England","Edward Tudor","Henry, Duke of Cornwall","Elizabeth I of England","Henry FitzRoy, 1st Duke of Richmond and Somerset","Henry Tudor"]
what wnba team is diana taurasi on?	["Phoenix Mercury"]
what works of art did leonardo da vinci produce?	["Ginevra de' Benci","The Last Supper","The Virgin and Child with St Anne and St John the Baptist","Mona Lisa","Benois Madonna","Madonna Litta","Lady with an Ermine","St. John the Baptist","The Virgin and Child with St. Anne","Annunciation"]
what would ap xin zhao do?	["Male"]
what year did adam morrison get drafted?	["2006 NBA Draft"]
what year did baltimore ravens win super bowl?	["Super Bowl XXXV","Super Bowl XLVII"]
what year did houston rockets win their first championship?	["1994 NBA Finals"]
what year did jimmy the rev sullivan die?	["1999"]
what year did president william henry harrison take office?	["3/4/1841"]
what year did ray allen join the nba?	["1996"]
what year did seattle seahawks go to the super bowl?	["2005 NFL season"]
what year did super mario bros 2 come out?	["Zilog Z80"]
what year did the baltimore ravens win superbowl?	["2000 NFL season"]
what year did the bulls get rodman?	["1995–96 NBA season"]
what year did the golden state warriors win their first nba championship?	["1975 NBA Finals"]
what year did the la kings win the cup?	["2012 Stanley Cup Finals"]
what year did the milwaukee brewers go to the world series?	["1974 Major League Baseball Season"]
what year did the orioles go to the world series?	["1983 World Series","1966 World Series","1970 World Series"]
what year did the phillies begin?	["1883"]
what year did the seahawks win the superbowl?	["2006 NFL season"]
what year does hitler die?	["Hitler and His Generals: Military Conferences 1942-1945"]
what years did joe montana win super bowl?	["Super Bowl XIX"]
what years did romney serve as governor?	["1/2/2003"]
what year was albert pujols rookie year?	["2001 Major League Baseball Season"]
what year was allen iverson mvp?	["2000–01 NBA season"]
what year was first world series?	["1903 World Series"]
what year was george w bush elected?	["George W. Bush presidential campaign, 2000"]
what year was hitler was born?	["Adolf Hitler was born in 1889 at Braunau am Inn, Austria, the son of a 52- year-old Habsburg customs official, Alois Schickelgruber Hitler, and his third wife, a young peasant girl named Klara Poelzl."]
what year was kenya moore crowned miss usa?	["Miss USA 1993"]
what year was lebron james rookie season?	["2003–04 NBA season"]
what year was the first miss america pageant held?	["1930 Miss America"]
when are the summer and winter olympics held?	["Once every two years"]
when did annie open?	["Annie (1977 original Broadway cast)"]
when did arsenal won the league?	["2004–05 FA Cup","FA Cup 2002–03","2002 FA Cup Final","FA Cup 1978–79","2005 FA Cup Final","2003 FA Cup Final","FA Cup 1997–98","FA Cup 1992–93","FA Cup 1970–71","2001–02 FA Cup"]
when did bill clinton go to college?	["University College, Oxford","Ramble Elementary","Yale Law School","Hot Springs High School","Georgetown University Law Center","Edmund A. Walsh School of Foreign Service","St. John's Catholic Elementary School"]
when did carolina panthers go to superbowl?	["2003 NFL season"]
when did celtics win the championship?	["1969 NBA Finals","1986 NBA Finals","2008 NBA Finals","1974 NBA Finals","1984 NBA Finals","1965 NBA Finals","1966 NBA Finals","1976 NBA Finals","1981 NBA Finals","1968 NBA Finals"]
when did charles goodyear invented rubber?	["During the early 1830's he began inventing, filing six patents between 1830 and 1834, and during this period became interested in rubber, which he tried - unsuccessfully - to use in some of his mechanical inventions."]
when did chipper jones get drafted?	["1990 Major League Baseball Draft"]
when did conflict start in ireland?	["Viking invasion of Ireland"]
when did florida marlins join mlb?	["1993 Major League Baseball Season"]
when did gordon brown resigns?	["7 January, 2007"]
when did juventus win the champions league?	["1996 UEFA Champions League Final"]
when did kaley cuoco join charmed?	["Charmed Season 8"]
when did kelly slater go pro?	["2008 ASP World Tour"]
when did liverpool fc last win the champions league?	["2006 FA Cup Final"]
when did mark mcgwire retired?	["2001 Major League Baseball season"]
when did michael jordan return to the nba?	["2001–02 NBA season"]
when did michael vick start playing for the eagles?	["2009 NFL season"]
when did pakistan get its independence?	["1947"]
when did president theodore roosevelt take office?	["9/14/1901"]
when did romney become governor?	["1/2/2003"]
when did roth ira originate?	["William V. Roth, Jr."]
when did shaq come into the nba?	["1992 NBA Draft"]
when did shays rebellion start?	["1786"]
when did the battle of alamo start?	["2/23/1836"]
when did the big earthquake hit san francisco?	["1906 San Francisco earthquake"]
when did the burma cyclone happen?	["1999 Odisha cyclone"]
when did the detroit pistons last win the championship?	["2004 NBA Finals"]
when did the jews stop making animal sacrifices?	["Yiddish Language"]
when did the lakers 3 peat?	["2000"]
when did the libyan conflict start?	["2011"]
when did the philadelphia flyers win the cup?	["1974 Stanley Cup Finals","1975 Stanley Cup Finals"]
when did the san francisco earthquake occur?	["1906 San Francisco earthquake"]
when did the wright brothers created their first plane?	["1900 Wright Glider"]
when did tony romo got drafted?	["2002"]
when did truman become president?	["4/12/1945"]
when did we start war with iraq?	["2001"]
when did william mckinley died?	["9/14/1901"]
when does daylight saving end in new zealand 2012?	["nz"]
when does jewish new year start?	["Yiddish Language"]
when does parliament sit in canberra?	["Old Parliament House, Canberra"]
when does school start for the university of oregon?	["University of Oregon"]
when does the mayan calendar end exactly?	["2012"]
when does the vietnam war end?	["1970s"]
when does the world end according to the mayans time?	["2012"]
when does the wsop main event start?	["1971 World Series of Poker"]
when does ziva start on ncis?	["NCIS - Season 3"]
when do they change the time in california?	["Pacific Time Zone","UTC-8"]
when do world war ii end?	["1942"]
when is nrl grand final day?	["NRL Grand Final"]
when is saint george day celebrated?	["April 23"]
when is st joseph birthday?	["March 19"]
when is the last time the denver broncos won the superbowl?	["Super Bowl XXXIII"]
when is the last time the giants won the world series?	["2012 World Series"]
when is the last time the pittsburgh steelers won a superbowl?	["Super Bowl XLIII"]
when is the last time the ravens won a superbowl?	["Super Bowl XLVII"]
when is the rainy season in bangkok thailand?	["September"]
when is venus brightest?	["Western astrology"]
when olympic games 2012 opening ceremony?	["The Olympic Odyssey"]
when's the last time the mets won the world series?	["1986 World Series"]
when's the last time the steelers won the superbowl?	["Super Bowl XLIII"]
when the atlanta braves won the world series?	["1995 World Series"]
when tupac was shot?	["Tupac 1994 assault"]
when was abe lincoln president?	["Abraham Lincoln 1865 presidential inauguration","Abraham Lincoln 1861 presidential inauguration"]
when was abraham lincoln declared president?	["Abraham Lincoln 1861 presidential inauguration"]
when was christopher columbus first expedition?	["1492 Conquest of Paradise"]
when was father chris riley born?	["1967"]
when was herbert hoover born and died?	["8/10/1874"]
when was john paul ii?	["10/16/1978"]
when was lucy lawless born?	["New Zealand"]
when was michael jordan at his best?	["1995–96 NBA season"]
when was president john adams elected?	["John Adams Presidential Campaign, 1796","John Adams Presidential Campaign, 1800"]
when was president wilson in office?	["1920"]
when was taylor swift fearless tour?	["Taylor Swift Fearless 2009 Tour"]
when was the last time knicks won the championship?	["1973 NBA Finals"]
when was the last time the boston bruins went to the stanley cup?	["2011 Stanley Cup Finals"]
when was the last time the dallas cowboys won the superbowl?	["Super Bowl XXX"]
when was the last time the dodgers won a championship?	["1988 World Series"]
when was the last time the la kings won a playoff series?	["2012 Stanley Cup Finals"]
when was the last time the ny knicks won a playoff game?	["1973 NBA Finals"]
when was the last time the orioles won the world series?	["1983 World Series"]
when was the last time the red sox won 100 games?	["1912 Major League Baseball Season"]
when was the last time the toronto maple leafs made the playoffs?	["1949 Stanley Cup Finals"]
when was the last time the toronto maple leafs were in the stanley cup finals?	["1967 Stanley Cup Finals"]
when was the last time the toronto maple leafs win the stanley cup?	["1967 Stanley Cup Finals"]
when was the last tsunami in the atlantic ocean?	["Île Saint-Joseph"]
when was the leafs last in the playoffs?	["1967 Stanley Cup Finals"]
when was the most recent earthquake in haiti?	["2010 Haiti Earthquake"]
when was the printing press invented by gutenberg?	["This suggests that by 1438 Gutenberg and Dritzehen had in all probability already invented a printing process using moveable type (separate pieces of wood or metal for each letter of the alphabet)."]
when were south australian women given the right to vote?	["Queensland","Northern Territory","Western Australia","New South Wales","Victoria"]
when will the world end mayans?	["2012"]
where all did picasso live?	["Málaga","France"]
where are boeing headquarters?	["Seattle","Chicago"]
where are english speakers distributed?	["Canada","Australia","Kingdom of Great Britain","United States of America","United Kingdom","Ireland","New Zealand"]
where are ike and tina turner's children?	["Ronnie Turner","Craig Hill"]
where are kohler sinks manufactured?	["Kohler"]
where are people who speak arabic from?	["Bahrain","Saudi Arabia","Libya","Algeria","Egypt","Kuwait","Lebanon","Israel","Jordan","Iraq"]
where are samsung based?	["Seoul"]
where are the gobi desert located on a map?	["Mongolia"]
where are the nato headquarters located?	["Netherlands","Poland","United States of America","United Kingdom","Germany","Bulgaria"]
where are the new orleans hornets moving to?	["New Orleans Arena"]
where are the nordic countries?	["Northern Europe"]
where are the sahara desert located?	["North Africa"]
where are the texas rangers playing?	["Rangers Ballpark in Arlington"]
where are the timezones in the usa?	["Pacific Time Zone"]
where are yamaha outboard motors manufactured?	["Shizuoka Prefecture"]
where are you from in malayalam?	["India"]
where bin laden got killed?	["Abbottabad"]
where buddha come from?	["Lumbini"]
where can i go running in sacramento?	["Boulevard Park"]
where can you find wind turbines in canada?	["Alberta"]
where can you go on eco holidays in the uk?	["World Bank, World Development Indicators, Life Expectancy"]
where did aaron rodgers go to high school?	["Pleasant Valley High School"]
where did abraham and his descendants live?	["Canaan"]
where did adolf hitler die?	["Berlin"]
where did african american slaves come from?	["African people"]
where did alexander graham bell die?	["Beinn Bhreagh, Nova Scotia"]
where did alex chilton die?	["New Orleans"]
where did al qaeda attack?	["Iraq War"]
where did andy murray started playing tennis?	["United Kingdom"]
where did anne frank go to school?	["Montessori Lyceum Amsterdam"]
where did antoine lavoisier die?	["Place de la Concorde"]
where did benjamin franklin went to school?	["Boston Latin School"]
where did benjamin franklin work?	["James Franklin Printing Shop","United States Postal Service","Josiah Franklin"]
where did bristol palin go to school?	["Wasilla High School","West Anchorage High School","Juneau-Douglas High School"]
where did buster posey go to high school?	["Leesburg"]
where did charles darwin and his wife live?	["Downe, Kent","England","London","Shrewsbury"]
where did charles darwin die?	["Down House"]
where did christopher columbus began his journey?	["Portugal"]
where did clay matthews go to school?	["Agoura High School","University of Southern California"]
where did crabtree go to college?	["Texas Tech University"]
where did cs lewis wrote?	["Belfast"]
where did derek fisher go to college?	["University of Arkansas at Little Rock"]
where did diego velazquez die?	["Madrid"]
where did djokovic come from?	["Serbia"]
where did dolly parton grow up?	["Tennessee"]
where did drew brees go to college wikianswers?	["Purdue University"]
where did dutch language come from?	["Europeans"]
where did edgar allan poe died?	["Baltimore"]
where did eleanor roosevelt die?	["New York City"]
where did emperor constantine die?	["Constantinople"]
where did emperor hirohito live?	["Japan"]
where did flemish people come from?	["Belgium"]
where did francisco coronado come from?	["Salamanca"]
where did frank baum die?	["Hollywood"]
where did george herbert walker bush go to college?	["Yale University","Phillips Academy","Davenport College"]
where did george michael go to school?	["Bushey Meads School"]
where did george washington carver go to collage?	["Tuskegee University","Iowa State University","Simpson College"]
where did george w bush live as a child?	["New Haven"]
where did giuliana rancic grow up?	["Naples"]
where did hank marvin come from?	["Newcastle upon Tyne"]
where did harper lee attend high school?	["Monroe County High School"]
where did harry s truman go to school?	["University of Missouri–Kansas City School of Law","University of Missouri–Kansas City","William Chrisman High School"]
where did holly madison get her breast implants?	["United States of America"]
where did hugo chavez go to school?	["Daniel Florencio O'Leary School","Universidad Simón Bolívar","Experimental Security University","Julian Pino School","Military academy of Venezuela"]
where did jay moriarty die?	["Maldives"]
where did jennifer arnold go to medical school?	["United States of America"]
where did joe flacco attend college?	["University of Delaware"]
where did john franklin live?	["Blue Island"]
where did john mayer go to college?	["Berklee College of Music"]
where did john steinbeck go to college?	["Stanford University"]
where did joseph's family live?	["Canaan"]
where did jovan belcher kill himself?	["Kansas City"]
where did jrr tolkien go to school?	["Exeter College, Oxford","University of Oxford"]
where did kansas city royals come from?	["Kansas City"]
where did kate gosselin grew up?	["Philadelphia"]
where did kennedy's inaugural address take place?	["John F. Kennedy 1961 presidential inauguration"]
where did kevin james go to college?	["SUNY College at Cortland"]
where did kevin love go to college?	["University of California, Los Angeles"]
where did kim jong il die?	["Pyongyang"]
where did kim kardashian come from?	["Los Angeles"]
where did kobe earthquake happen?	["Great Hanshin earthquake"]
where did leif ericson grow up?	["Iceland"]
where did louis sachar grow up?	["East Meadow"]
where did madonna grew up?	["Bay City"]
where did margaret hoover go to college?	["Davidson College"]
where did mario lopez go to school?	["Chula Vista High School"]
where did martin luther king got shot at?	["Memphis"]
where did mary bell live?	["Newcastle upon Tyne"]
where did melba beals live?	["Arkansas"]
where did michelle obama graduated from?	["Harvard Law School","Whitney M. Young Magnet High School","Princeton University"]
where did mitt romney's parents come from?	["Bloomfield Hills"]
where did morgan freeman graduate?	["Jackson State University","Los Angeles City College"]
where did mubarak get his wealth?	["Politician"]
where did nat turner 1831 rebellion occur?	["Virginia"]
where did otto frank go to college?	["Heidelberg College"]
where did paula deen go to school?	["Albany High School"]
where did queensland get its name from?	["Queen Victoria"]
where did richard arkwright grow up?	["England"]
where did richard nixon die?	["New York City"]
where did rick santorum attend high school?	["Carmel High School"]
where did robert downey jr go to jail?	["California Substance Abuse Treatment Facility and State Prison, Corcoran"]
where did robert kardashian go to college?	["University of San Diego","University of San Diego School of Law","University of Southern California"]
where did robin cook die?	["Inverness"]
where did robin williams get married?	["St. Helena"]
where did rob kardashian go to school?	["University of Southern California","Marshall School of Business"]
where did romney graduated college?	["Stanford University","Cranbrook Schools","Harvard Law School","Harvard Business School","Harvard University","Brigham Young University"]
where did rudolf virchow conduct his research?	["Humboldt University of Berlin","University of Würzburg"]
where did russians originate?	["East Slavs","Europeans"]
where did sally pearson go to primary school?	["Helensvale State High School"]
where did salvador dali study art?	["Real Academia de Bellas Artes de San Fernando"]
where did sanjay gupta go to school?	["University of Michigan","University of Michigan Health System","Novi High School"]
where did scott fitzgerald go to college?	["Princeton University"]
where did spencer pratt go to school?	["University of Southern California"]
where did starbucks get their logo?	["Howard Schultz"]
where did tennessee williams go to college?	["Washington University in St. Louis","University of Missouri–Columbia","University of Iowa","The New School"]
where did the anasazi indians live?	["Four Corners"]
where did the australian floods take place?	["Queensland"]
where did the battle of passchendaele happen?	["Passendale"]
where did the battle of waterloo occur?	["Waterloo"]
where did the crimean war take place?	["Caucasus","White Sea","Baltic Sea","Balkans","Black Sea","Crimea"]
where did the gallipoli war take place?	["Gallipoli"]
where did the gettysburg address?	["Gettysburg"]
where did the greek alphabet come from?	["Indo-European languages"]
where did the iroquois indians come from?	["Québec"]
where did the israel palestine conflict start?	["1936–39 Arab revolt in Palestine"]
where did the latin language originate from?	["Italic languages","Indo-European languages"]
where did the mississippi river end?	["Gulf of Mexico"]
where did theodor schwann get his education?	["Humboldt University of Berlin"]
where did theodor schwann study?	["Humboldt University of Berlin"]
where did the russian japanese war happen?	["Yellow Sea","Korean Peninsula","Manchuria"]
where did the second battle of ypres occur?	["Belgium"]
where did the taliban began?	["Afghanistan"]
where did they find jenni rivera's body?	["Iturbide, Nuevo León"]
where did they get the name stanley cup?	["Frederick Stanley, 16th Earl of Derby"]
where did the yoruba originated from?	["African people"]
where did thomas hobbes live?	["Westport, Wiltshire"]
where did thomas paine die?	["New York City"]
where did tim tebow grow up?	["Manila"]
where did tony gonzalez play college basketball?	["University of California, Berkeley"]
where did troy aikman play football?	["Dallas Cowboys"]
where did venus williams come from?	["Lynwood"]
where did vince scully go to college?	["Fordham University"]
where did william morris go to college?	["Marlborough College","Exeter College, Oxford","University of Oxford"]
where do american bulldogs originate from?	["United States of America"]
where do burmese cats originate from?	["Asia"]
where does airtran airways fly?	["LaGuardia Airport","Southwest Florida International Airport","Indianapolis International Airport","Logan International Airport","Chicago Midway International Airport","Fort Lauderdale–Hollywood International Airport","General Mitchell International Airport","Akron-Canton Airport","Port Columbus International Airport","Tampa International Airport"]
where does archbishop desmond tutu live?	["South Africa"]
where does bradley walsh live?	["England"]
where does bronx begin?	["Yankee Stadium"]
where does carlos santana live?	["Jalisco"]
where does chef ina garten live?	["Brooklyn"]
where does dave ramsey live?	["Nashville"]
where does delaware river start?	["West Branch Delaware River","Mount Jefferson"]
where does egypt export to?	["Sudan"]
where does fabio capello come from?	["Italy"]
where does freddie ljungberg come from?	["Sweden"]
where does greek language come from?	["Indo-European languages"]
where does houston dynamo play?	["Houston"]
where does kate middleton live 2012?	["Reading"]
where does kurdish people live?	["Asia"]
where does lil wayne go to school?	["University of Houston"]
where does marta play soccer?	["Umeå IK"]
where does michelle pfeiffer live now?	["Orange County"]
where does name pennsylvania come from?	["William Penn"]
where does princess leia live?	["Alderaan"]
where does robert irvine come from?	["Salisbury"]
where does robin williams live 2011?	["San Francisco"]
where does russia import from?	["Uzbekistan"]
where does sami yusuf live?	["United Kingdom"]
where does sherrod brown live?	["Mansfield"]
where does the celtics practice?	["TD Bank Garden"]
where does the city of paris get its name?	["Parisii"]
where does the columbia river start?	["Columbia Lake"]
where does the expression excuse my french come from?	["English Literature"]
where does the parana river flow?	["Paraguay","Brazil","Argentina","Mesopotamia, Argentina"]
where does the shannon river start and end?	["Shannon Pot"]
where does the tennessee river go?	["Lenoir City","Knoxville","Savannah","Kingston","New Johnsonville","Signal Mountain","Grand Rivers","Crump","Killen","Loudon"]
where does the zambezi river originate?	["Tanzania"]
where does the zambezi river start?	["Mwinilunga"]
where does tim cook work?	["Apple Inc."]
where does tim roth come from?	["England"]
where does toronto get its water from?	["Ashbridges Bay Wastewater Treatment Plant"]
where do flemish come from?	["Belgium"]
where do florida panthers play?	["BB&T Center"]
where do ireland play rugby union?	["Zarathustra"]
where do italy people live?	["Italy"]
where do i vote milwaukee wisconsin?	["United States of America","Wisconsin"]
where do john lennon die?	["New York City"]
where do kfc get their chicken from?	["Kentucky"]
where do most illegal immigrants in the us come from?	["Mexico"]
where do most of the people live in russia?	["Moscow"]
where do scottish people originate from?	["Celts","Europeans"]
where do the appalachian mountains run?	["Eastern United States"]
where do the appalachian mountains run through?	["Eastern United States"]
where do the blackhawks play?	["United Center"]
where do the chicago white sox play home games?	["U.S. Cellular Field"]
where do the florida marlins play spring training?	["University of Florida"]
where do the seattle seahawks play?	["CenturyLink Field"]
where do they speak afrikaans?	["Namibia","South Africa"]
where do they speak german?	["Canada","German Democratic Republic","Luxembourg","Switzerland","Liechtenstein","Germany","West Germany","Belgium","Vatican City","Second Polish Republic"]
where do they speak tibetan?	["Tibet"]
where do they speak turkish?	["Turkey","Republic of Macedonia","Austria","Cyprus","Republic of Kosovo"]
where english is spoken?	["Canada","Australia","South Africa","Zambia","United Kingdom","Zimbabwe","Uganda","New Zealand","Turks and Caicos Islands","Tanzania"]
where george lopez was born?	["Mission Hills"]
where has the english language evolved from?	["West Germanic languages"]
where herman cain stance on the issues?	["Évocateur: The Morton Downey Jr. Movie"]
where honduras in the world?	["Central America"]
where is ancient phoenician?	["Lebanon"]
where is arabic most spoken?	["Saudi Arabia"]
where is auburn university located?	["Alabama","Auburn University Historic District","United States of America","Auburn"]
where is audrey hepburn from?	["Ixelles"]
where is augusta masters 2012?	["Augusta National Golf Course"]
where is belgium germany?	["Western Europe"]
where is bob marley buried?	["Bob Marley Mausoleum"]
where is burundi country?	["Africa"]
where is byron nelson 2012?	["Roanoke"]
where is chesapeake bay bridge?	["Anne Arundel County","Queen Anne's County"]
where is chris paul from?	["United States of America"]
where is chris rock from?	["Andrews"]
where is daud ibrahim?	["Maharashtra"]
where is denmark situated?	["Euroregion Baltic"]
where is denmark south carolina?	["South Carolina","Bamberg County","United States of America"]
where is dwayne johnson ethnicity?	["African American","Samoan American"]
where is dwight howard now?	["Los Angeles Lakers"]
where is electrolux based?	["Stockholm"]
where is english spoken around the world?	["Canada","Australia","Kingdom of Great Britain","United States of America","United Kingdom","Ireland","New Zealand"]
where is english spoken in the world map?	["Canada","Australia","Kingdom of Great Britain","United States of America","United Kingdom","Ireland","New Zealand"]
where is french spoken most?	["France"]
where is giza pyramids located?	["Egypt","Giza Governorate"]
where is glastonbury england?	["United Kingdom","Mendip"]
where is harley davidson corporate headquarters?	["Milwaukee"]
where is harley davidson made?	["United States of America"]
where is harvard university?	["Massachusetts"]
where is holy roman empire located?	["Europe","North Africa","Middle East"]
where is ibrahim afellay from?	["Utrecht"]
where is isthmus of panama located on the map?	["Costa Rica","Colombia"]
where is jamarcus russell from?	["Mobile"]
where is jason mraz from?	["Mechanicsville"]
where is jay leno from?	["New Rochelle"]
where is kansas city?	["Platte County"]
where is laos in world map?	["Cambodia"]
where is mali located?	["Africa","West Africa"]
where is midlothian scotland?	["United Kingdom","Scotland","United Kingdom, with Dependencies and Territories"]
where is mission san buenaventura located?	["Ventura County"]
where is mitt romney's family from?	["Detroit"]
where is mount fuji located?	["Honshu"]
where is mount st helens volcano?	["Skamania County"]
where is mt st helens located?	["Skamania County","Washington"]
where is nineveh city?	["Iraq"]
where is olympic national park located?	["Washington"]
where is olympic national park wa?	["Jefferson County","Washington"]
where is perpignan located?	["France"]
where is president kennedy buried?	["Arlington National Cemetery"]
where is roswell area 51?	["Roswell"]
where is shakira from?	["Colombia"]
where is south portland?	["United States of America","Maine","Cumberland County"]
where is spanish spoken most?	["Spain"]
where is staten island ferry?	["Staten Island"]
where is taylor swift from?	["Reading"]
where is tennessee river?	["Tennessee"]
where is the arizona cardinals stadium located?	["Glendale"]
where is the carpathian mountain range located?	["Ukraine","Europe","Romania","Czech Republic","Poland","Serbia","Slovakia","Hungary"]
where is the chernobyl nuclear power plant?	["Prypiat","Ukrainian SSR","Chernobyl Nuclear Power Plant","Chernobyl"]
where is the city wales?	["United Kingdom","United Kingdom, with Dependencies and Territories"]
where is the ellen degenerous show filmed?	["Beverly Hills"]
where is the empire of ghana?	["West Africa"]
where is the euphrates and tigris river located on a map?	["Turkey","Syria","Iraq","Iran"]
where is the fukushima daiichi nuclear plant located?	["Japan","Okuma"]
where is the fukushima daiichi nuclear power station?	["Japan","Okuma"]
where is the galapagos islands located on a world map?	["Pacific Ocean","Galápagos Province"]
where is the headquarters of bank of america?	["Charlotte"]
where is the home stadium of the new england patriots?	["uk"]
where is the illinois river on a map?	["Illinois"]
where is the latin language from?	["Italic languages","Indo-European languages"]
where is the main branch of bank of america?	["Charlotte"]
where is the main headquarters of google?	["California"]
where is the mts iceplex in winnipeg?	["Canada"]
where is the national ffa foundation located today?	["Indianapolis"]
where is the nra headquarters located?	["Fairfax"]
where is the phillies spring training stadium?	["Philadelphia"]
where is the riviera casino?	["Las Vegas"]
where is the scottish house in skyfall?	["Celts"]
where is the seat of the african union?	["Addis Ababa"]
where is the seychelles on world map?	["Africa"]
where is the sony ericsson company?	["London"]
where is the thames river source?	["Thames Head"]
where is the time zone line in south dakota?	["Mountain Time Zone","Central Time Zone","UTC−07:00","UTC−06:00"]
where is the ufc headquarters?	["Las Vegas"]
where is the un based?	["New York City"]
where is the university of maryland medical school?	["Maryland","United States of America","Baltimore"]
where is the university of the rockies located?	["United States of America","Colorado","Colorado Springs"]
where is traditional chinese used?	["Canada","Brunei","Singapore","Malaysia","Shěn","Vietnam","China"]
where is tunis on a map?	["Tunisia","Africa","Tunis Governorate"]
where is tupac from originally?	["East Harlem"]
where is tyrese gibson from?	["Watts"]
where is victoria british columbia?	["Canada"]
where is walton county ga?	["Atlanta-Sandy Springs-Marietta, GA Metropolitan Statistical Area","Georgia"]
where is walton indiana?	["Indiana","Cass County","United States of America","Tipton Township"]
where laura ingalls wilder lived?	["South Dakota","Wisconsin"]
where michael jackson from?	["Gary"]
where obama went to school?	["Occidental College","Harvard Law School","Noelani Elementary School","Punahou School","State Elementary School Menteng 01","St. Francis of Assisi Catholic School","Columbia University"]
where president obama was born?	["Honolulu"]
where should a family stay in paris?	["Hôtel Ritz Paris","Hôtel de Crillon"]
where the missouri river ends?	["Mississippi River"]
where to eat crawfish in beaumont?	["Uzooma Okeke"]
where to exchange euros in new york city?	["John F. Kennedy International Airport"]
where to get a marriage license in long island?	["United States District Court for the Eastern District of New York"]
where to go fishing in roanoke va?	["Rainbow Bluff Expedition"]
where to go in ibiza for families?	["Valencia"]
where to go in vietnam beaches?	["Đắk Nông Province"]
where to stay in chicago tourist?	["Hotel Sax Chicago"]
where to stay in singapore blog?	["Central Region, Singapore"]
where to visit in paris with children?	["Musée Maillol","Palace of Versailles","Eiffel Tower","Île de la Cité","Café Volpini","Notre Dame de Paris","Folies Bergère","Arc de Triomphe","Basilica of the Sacré Cœur","Panthéon, Paris"]
where turkish people originate?	["Turkey","Republic of Macedonia","Austria","Cyprus","Republic of Kosovo"]
where was anne boleyn executed?	["Tower of London"]
where was auschwitz concentration camp located?	["Poland"]
where was barack hussein obama sr born?	["Honolulu"]
where was benjamin franklin educated?	["Boston Latin School"]
where was bin laden found and killed?	["Abbottabad"]
where was caesar when he was stabbed?	["Theatre of Pompey"]
where was country singer george jones born?	["Saratoga"]
where was david berkowitz arrested?	["New York City"]
where was elvis costello born?	["Paddington"]
where was farrah fawcett buried?	["Westwood Village Memorial Park Cemetery"]
where was franz ferdinand from?	["Glasgow"]
where was george washington carver from?	["Diamond"]
where was huey newton killed?	["Oakland"]
where was jesus after he died on the cross?	["Church of the Holy Sepulchre"]
where was john f kennedy when he got shot?	["Dallas"]
where was john jay born?	["New York City"]
where was marilyn monroe found dead?	["Brentwood"]
where was martin luther king jr buried?	["Martin Luther King, Jr., National Historic Site"]
where was martin luther king jr raised?	["Atlanta"]
where was mary todd lincoln from?	["Lexington","Springfield"]
where was mission san rafael located?	["California"]
where was osama bin laden killed?	["Abbottabad"]
where was rihanna born and raised?	["Saint Michael Parish","Barbados"]
where was rihanna raised?	["Saint Michael Parish","Barbados"]
where was shakespeare born at?	["Stratford-upon-Avon"]
where was st. lucy born?	["Syracuse"]
where was st peter killed?	["Rome"]
where was teddy roosevelt's house?	["New York City"]
where was terry waite born?	["Bollington"]
where was the assyrian homeland?	["Middle East"]
where was the boston tea party 1773?	["Boston Harbor"]
where was the city of david?	["Bethlehem"]
where was the first gulf war fought?	["Israel","Arabian Peninsula","Kuwait","Saudi Arabia","Persian Gulf","Iraq"]
where was the first microsoft headquarters located?	["Redmond"]
where was theodore roosevelt buried?	["Youngs Memorial Cemetery"]
where was the ottoman empire based?	["Austria-Hungary","Kingdom of Bulgaria","German Empire"]
where was the palace of knossos located?	["Crete","Greece"]
where was the prophet mohammed from?	["Mecca"]
where was the temple of karnak built?	["Egypt","Luxor Governorate"]
where was the vietnam war location?	["South Vietnam","North Vietnam","Southeast Asia","Cambodia","Vietnam","Laos"]
where was toussaint l'ouverture born?	["Haiti"]
where were greek temples built?	["Europe"]
where were the great pyramids of giza built?	["Giza Plateau"]
where were the seneca indians located?	["New York"]
where will tebow go in 2013?	["New York Jets"]
which airport to fly into in buenos aires?	["Aeroparque Jorge Newbery","Ministro Pistarini International Airport","Don Torcuato Airport"]
which airport to fly into rome?	["Ciampino – G.B. Pastine International Airport","Roma Termini railway station","Civitavecchia Ferry Terminal","Leonardo da Vinci–Fiumicino Airport"]
which barcelona airport is closest to the port?	["Barcelona–El Prat Airport"]
which city is the oldest in pakistan?	["Bahawalpur"]
which continental congress approve the declaration of independence?	["Second Continental Congress"]
which continents were part of the roman empire?	["Europe","North Africa","Middle East"]
which countries have spanish as their main language?	["Honduras","Uruguay","El Salvador","Panama","Equatorial Guinea","Andorra","Guatemala","Puerto Rico","Paraguay","Belize"]
which countries in africa were slaves taken from?	["Angola","Chad","Algeria","Cape Verde","Botswana","Central African Republic","Burundi","Cameroon","Burkina Faso","Benin"]
which countries share a border with russia?	["Ukraine","Belarus","Kazakhstan","Poland","Lithuania","Azerbaijan","Mongolia","North Korea","Georgia","Norway"]
which countries speak arabic language?	["Bahrain","Saudi Arabia","Libya","Algeria","Egypt","Kuwait","Lebanon","Israel","Jordan","Iraq"]
which countries speak germanic languages?	["Icelanders","Dutch people","Austrians","Faroese people","Danes","Flemish people","Frisians","Swedes","Germans","English people"]
which countries speak german officially?	["Canada","German Democratic Republic","Luxembourg","Switzerland","Liechtenstein","Germany","West Germany","Belgium","Vatican City","Second Polish Republic"]
which country did nike originate from?	["United States of America"]
which country does greenland belong to?	["Denmark"]
which country in europe has the largest land area?	["Russia"]
which country in north america is divided into provinces?	["Canada"]
which country invented nike?	["United States of America"]
which country was justin bieber born in?	["Canada"]
which country was michael jackson born?	["United States of America"]
which country won the crimean war?	["Russian Empire"]
which dawkins book to read first?	["The Selfish Gene"]
which hemingway book to read?	["A Farewell to Arms"]
which island is kailua on?	["Hawaii"]
which is the main train station in rome?	["Roma Termini railway station"]
which ocean does the zambezi river flow into?	["Indian Ocean"]
which of the following does australia export the most?	["Energy","Agriculture"]
which of the following was a contribution thomas hunt morgan made to genetics?	["Chromosome"]
which political party does barack obama represent?	["Democratic Party"]
which state did anne hutchinson found?	["Rhode Island"]
which states does the colorado river run through?	["Utah","Arizona","Nevada","California","Colorado"]
which university did michael bay graduated from?	["Crossroads School","Pasadena's Art Center College of Design","Wesleyan University","Art Center College of Design"]
who are china's neighbors?	["Pakistan","Kyrgyzstan","Myanmar","Bhutan","Afghanistan","Tajikistan","India","Mongolia","Laos","Kazakhstan"]
who are serena williams parents?	["Richard Williams","Oracene Price"]
who are the 9 justices of the supreme court 2011?	["John Roberts","Clarence Thomas","David Souter","John Paul Stevens","Edward Douglass White"]
who are the coaches for the oakland raiders?	["Dennis Allen"]
who are the colorado representatives?	["Wayne Allard","Ken Salazar","Gordon L. Allott","Hank Brown","Edwin C. Johnson","William L. Armstrong","Floyd K. Haskell","Mark Udall","Michael Bennet"]
who are the judges appointed in the supreme court?	["John Roberts","Clarence Thomas","David Souter","John Paul Stevens","Edward Douglass White"]
who are the members of the supreme court 2009?	["John Roberts"]
who are the senators of hawaii 2012?	["Daniel Inouye","Spark Matsunaga","Hiram Fong","Brian Schatz","Daniel Kahikina Akaka","Oren E. Long","Mazie Hirono"]
who are the senators of new jersey now?	["Bob Menendez"]
who are the senators of virginia 2013?	["Mark Warner"]
who are the st louis cardinals coaches?	["Dave McKay","José Oquendo","Joe Pettini","Marty Mason","Dave Duncan","Hal McRae"]
who are the u s senators of pennsylvania?	["James Buchanan","Albert Gallatin","Bob Casey, Jr.","George Clymer","Arlen Specter","Robert Morris","William Maclay","Michael J. Holston","Pat Toomey","James Ross"]
who are the virginia senators 2013?	["Mark Warner"]
who became president when henry harrison died?	["John Tyler"]
who brad pitt has dated?	["Angelina Jolie","Robin Givens","Jennifer Aniston","Gwyneth Paltrow","Juliette Lewis","Sinitta","Thandie Newton","Shalane McCall","Jill Schoelen"]
who coaches the carolina panthers?	["Ron Rivera"]
who created arthur?	["WGBH","Marc Brown"]
who designed national flag of italy?	["Corriere della Sera","l'Unità","Il Foglio","la Repubblica","Il Messaggero","La Domenica del Corriere","La Stampa","Avanti!","La Gazzetta dello Sport","Liberazione"]
who developed the tcp ip reference model?	["Robert E. Kahn","Vint Cerf"]
who did annie oakley married?	["Frank E. Butler"]
who did armie hammer play in the social network?	["Jesse Eisenberg"]
who did australia fight in the first world war?	["United Kingdom","United States of America","Italy","Russia","France"]
who did ben franklin marry?	["Deborah Read"]
who did benjamin franklin get married to?	["Deborah Read"]
who did ben stiller date?	["Christine Taylor"]
who did brett gardner play for in 2008?	["New York Yankees"]
who did cam newton sign with?	["Carolina Panthers"]
who did carlos boozer play for?	["Utah Jazz","Cleveland Cavaliers"]
who did carrie ann inaba get engaged to?	["Jesse Sloan"]
who did cher have a son with?	["Sonny","Gregg Allman"]
who did cliff lee play for last year?	["Philadelphia Phillies"]
who did cristiano ronaldo play for in 2010?	["Real Madrid C.F."]
who did darth vaders voice?	["James Earl Jones"]
who did denise van outen married?	["Lee Mead"]
who did france surrender to in ww2?	["Germany"]
who did george w. bush run against for the second term?	["Al Gore"]
who did gerald ford select as his vice president when he became president?	["Nelson Rockefeller"]
who did granville t. woods married?	["Loretta Woods"]
who did jackie robinson first play for?	["Montreal Royals","Kansas City Monarchs","Los Angeles Bulldogs","Brooklyn Dodgers","UCLA Bruins football"]
who did james franco play in milk?	["Him/Herself"]
who did jennifer lawrence play in x men?	["Mystique"]
who did john kennedy have affairs with?	["william averell harriman appointed by john fitzgerald kennedy"]
who did johnny depp play in corpse bride?	["Victor Van Dort"]
who did kimberly williams marry?	["Brad Paisley"]
who did kim richards marry?	["Greg Davis","John Jackson","G. Monty Brinson"]
who did kurt warner play 4?	["St. Louis Rams","New York Giants","Iowa Barnstormers","Arizona Cardinals","Northern Iowa Panthers football","Amsterdam Admirals"]
who did lbj marry?	["Lady Bird Johnson"]
who did marilyn monroe marry at 16?	["James Dougherty"]
who did messi have a baby with?	["Antonella Roccuzzo"]
who did michael j fox marry?	["Tracy Pollan"]
who did morgan freeman marry?	["Myrna Colley-Lee"]
who did mozart write his four horn concertos for?	["wolfgang amadeus mozart used story by pierre beaumarchais"]
who did nasri play for before arsenal?	["Olympique de Marseille"]
who did paul revere marry?	["Sarah Revere"]
who did queen elizabeth 1 executed?	["queen elizabeth i of england she executed mary queen of scots"]
who did reese witherspoon get married to?	["Ryan Phillippe"]
who did richard nixon run against?	["richard milhous nixon lost election to john fitzgerald kennedy"]
who did ricky martin started his career with?	["Menudo"]
who did roger federer married?	["Mirka Federer"]
who did sandra bullock marry?	["Jesse James"]
who did scarlett johansson date?	["Justin Timberlake","Josh Hartnett","Benicio del Toro","Jared Leto","Derek Jeter"]
who did shaq first play for?	["Orlando Magic"]
who did sir francis drake marry?	["Mary Newman","Elizabeth Sydenham"]
who did steve spurrier play pro football for?	["San Francisco 49ers"]
who did taft defeated in 1908?	["Theodore Roosevelt"]
who did terrell owens play for in 2010?	["Cincinnati Bengals"]
who did the chargers draft in 2011?	["Frank Summers"]
who did the cleveland cavaliers draft?	["J. J. Hickson","LeBron James","Shannon Brown","Luke Jackson","Dion Waiters"]
who did the voice for lola bunny?	["Britt McKillip","Kath Soucie"]
who did the voice of darth vader in episode 3?	["Hayden Christensen"]
who did tim tebow play college football for?	["University of Florida"]
who did tom hanks play in apollo 13?	["Jim Lovell"]
who did tom landry play for?	["Texas Longhorns football","New York Giants","New York Yankees"]
who did vasco de gama explore for?	["Portugal"]
who did veronica lake mary?	["André De Toth","Joseph A. McCarthy","Robert Carleton-Munro","John S. Detlie"]
who did viggo mortensen play in lord of the rings?	["Aragorn"]
who did vladimir lenin marry?	["Nadezhda Krupskaya"]
who did william shakespeare marry?	["Anne Hathaway"]
who did woody harrelson play on cheers?	["Woody Boyd"]
who does albert pujols play for 2012?	["Los Angeles Angels of Anaheim"]
who does alyson stoner play in camp rock?	["Caitlyn Gellar"]
who does amy stiller play in dodgeball?	["Keno Waitress"]
who does brian dawkins play for 2011?	["Denver Broncos"]
who does chris hemsworth have a baby with?	["Elsa Pataky"]
who does darth vaders voice?	["James Earl Jones"]
who does david beckham play for?	["Paris Saint-Germain F.C."]
who does don draper gets engaged to?	["Betty Draper"]
who does donnie wahlberg play in the sixth sense?	["Vincent Grey"]
who does japan import from?	["Canada","Sudan","Tanzania","United States of America","Kiribati","New Zealand"]
who does jeremy lin play for?	["Houston Rockets"]
who does jeremy shockey play for in 2012?	["Carolina Panthers"]
who does jordan palmer play for?	["Jacksonville Jaguars"]
who does kellan lutz play in prom night?	["Mark Rider"]
who does kroy biermann play football for?	["Atlanta Falcons"]
who does lee clark manager?	["Birmingham City F.C."]
who does michael keaton play in cars?	["Chick Hicks"]
who does michael oher play for in 2010?	["Baltimore Ravens"]
who does mike marry at the end of season 5 desperate housewives?	["Susan Delfino"]
who does mila kunis play on family guy?	["Meg Griffin"]
who does myles kennedy sing for?	["Alter Bridge"]
who does nolan ryan play for?	["California Angels","New York Mets"]
who does owen schmitt play for?	["Seattle Seahawks"]
who does peter griffin voice?	["Seth MacFarlane"]
who does peyton manning play football for?	["Denver Broncos"]
who does portugal trade with?	["Angola","Algeria","Libya","Tunisia","Morocco","Mozambique"]
who does ronaldinho play for now 2011?	["Clube de Regatas do Flamengo"]
who does ron stoppable's voice?	["Will Friedle"]
who does the voice for chucky in child's play?	["Brad Dourif"]
who does the voice for darth vader?	["James Earl Jones"]
who do islamic people follow?	["Allah"]
who do islamic people pray to?	["Allah"]
who do pagans worship?	["Odin"]
who financed sir francis drake?	["francis drake commissioned by queen elizabeth i of england"]
who formed the american federation of labor?	["Samuel Gompers"]
who fought in the battle of vicksburg?	["Confederate States of America","Union","John C. Pemberton","United States of America","Ulysses S. Grant"]
who fought in the gulf war 1991?	["Saudi Arabia","Australia","United States of America","France","United Kingdom","Argentina","Iraq"]
who fought the battle of gettysburg?	["Confederate States of America","United States of America"]
who founded new york university?	["Albert Gallatin","Mordecai Manuel Noah"]
who founded the afl?	["Bud Adams"]
who founded the kkk?	["Albert Pike","David Duke","William Joseph Simmons"]
who founded the pittsburgh steelers in 1933?	["Rooney family"]
who has coached the carolina panthers?	["George Seifert","Dom Capers","John Fox"]
who has played lex luthor?	["Anthony LaPaglia","Kevin Spacey","Clancy Brown","James Marsters","Gene Hackman"]
who has pudge rodriguez played for?	["Texas Rangers"]
who has ray allen dated?	["Shannon Walker Williams"]
who has stephen ireland played for?	["Manchester City F.C.","Newcastle United F.C.","Aston Villa F.C."]
who helped eminem started his career?	["Dr. Dre"]
who influenced picasso art?	["Édouard Manet","Paul Cézanne","Henri Rousseau","Paul Gauguin","Sara Murphy","Diego Velázquez","Jean Auguste Dominique Ingres","Eugène Delacroix","Alfred Jarry","Francisco Goya"]
who influenced samuel taylor coleridge?	["William Wordsworth"]
who inspired obama?	["Saul Alinsky","Nipsey Russell"]
who invented islamic religion?	["Muhammad"]
who is amy grant's first husband?	["Vince Gill"]
who is angelina jolie?	["Actor"]
who is angelina jolie mom and dad?	["Jon Voight","Marcheline Bertrand"]
who is angelina jolies brother?	["James Haven"]
who is anne hathaway parents?	["Gerald Hathaway","Kate McCauley Hathaway"]
who is captain james cook facts?	["Explorer"]
who is dirk nowitzki wife?	["Jessica Olsson"]
who is dustin johnson the golfer?	["Golfer"]
who is eli whitney and what did he invent?	["Cotton gin"]
who is emma stone father?	["Jeff Stone"]
who is gimli's father in the hobbit?	["Gloin"]
who is governor of ohio 2011?	["John Kasich"]
who is hammurabi and what did he do?	["Monarch"]
who is in charge of libya now?	["President of the General National Congress of Libya"]
who is in paul ryan's family?	["Elizabeth Ryan","Charles Ryan","Samuel Ryan"]
who is in the american league in baseball?	["Chicago White Sox","Baltimore Orioles","Los Angeles Angels of Anaheim","Detroit Tigers","Boston Red Sox","New York Yankees","Oakland Athletics","Minnesota Twins","Cleveland Indians","Kansas City Royals"]
who is jacob latimore?	["Singer","Actor"]
who is jake gyllenhaal married to?	["Kirsten Dunst"]
who is james madison and what did he do?	["United States Representative","United States Secretary of State","President of the United States"]
who is jamie little engaged to?	["Cody Selman"]
who is jimmy savile?	["Presenter"]
who is john cena married to?	["Elizabeth Huberdeau"]
who is judy garland father?	["Francis Avent Gumm"]
who is kevin jonas married to?	["Danielle Deleasa"]
who is keyshia cole dad?	["Leon Cole"]
who is khloe kardashian's husband?	["Lamar Odom"]
who is lamar odom playing for this year?	["Los Angeles Clippers"]
who is louisiana state senator?	["Mary Landrieu"]
who is martin luther king jr facts?	["Preacher","Writer","Pastor","Peace activist"]
who is mary mcleod bethune for kids?	["Educator"]
who is meredith gray married to in real life?	["Dr. Derek Shepherd"]
who is michael buble?	["Singer","Actor","Singer-songwriter"]
who is michael j fox parents?	["Phyllis Piper","William Fox"]
who is michael j fox's wife?	["Tracy Pollan"]
who is michael j fox wife?	["Tracy Pollan"]
who is moira en x men?	["Mutant"]
who is moira in x men?	["Olivia Williams","Rose Byrne"]
who is my representative in illinois house?	["Richard B. Ogilvie","Otto Kerner, Jr.","George Ryan","Pat Quinn","Rod Blagojevich","James R. Thompson","Jesse White","Daniel Walker","Jim Edgar","Samuel H. Shapiro"]
who is my state senator arizona?	["John McCain"]
who is niall ferguson's wife?	["Ayaan Hirsi Ali"]
who is nick lachey married to?	["Vanessa Minnillo"]
who is nicolas cage married too?	["Nicolas Cage; Katherine Heigl"]
who is number 22 for the dallas cowboys?	["Felix Jones"]
who is number 22 on miami dolphins?	["Reshad Jones"]
who is on the board of facebook?	["Mark Zuckerberg"]
who is president of israel?	["Shimon Peres"]
who is princess leia in star wars?	["Carrie Fisher"]
who is richard pryor son?	["Franklin Pryor","Steven Pryor","Richard Pryor Jr.","Rain Pryor","Kelsey Pryor","Elizabeth Pryor","Renee Pryor"]
who is rick scott?	["Investor","Businessperson","Politician","Lawyer"]
who is robin roberts father?	["Lawrence E. Roberts"]
who is ruling libya?	["Mohammed Magariaf"]
who is running for vice president with barack obama 2012?	["Joe Biden"]
who is ryan reynolds married to 2012?	["Blake Lively"]
who is shakira married to?	["Gerard Piqué"]
who is sir francis bacon?	["Philosopher"]
who is sir james dyson?	["Designer","Industrial designer","Engineer","Inventor"]
who is tatyana ali parents?	["Sonia Ali","Sheriff Ali"]
who is the arizona cardinals backup quarterback?	["John Skelton"]
who is the coach for the new york knicks?	["Mike Woodson"]
who is the coach of the sf giants?	["Tim Flannery"]
who is the current governor of arizona 2010?	["Jan Brewer"]
who is the current leader of france 2010?	["Nicolas Sarkozy"]
who is the current ohio state senator?	["Rob Portman"]
who is the governor of arizona 2009?	["Jan Brewer"]
who is the governor of indiana 2009?	["Mitch Daniels"]
who is the governor of pennsylvania state now?	["Tom Corbett"]
who is the governor of virginia 2011?	["Bob McDonnell"]
who is the head coach of inter milan?	["Andrea Stramaccioni"]
who is the king of cambodia now?	["Norodom Sihamoni"]
who is the leader of libya 2011?	["Muammar al-Gaddafi"]
who is the leader of north korea today?	["Kim Jong-un"]
who is the miami dolphins quarterback?	["Pat Devlin"]
who is the minority leader of the house of representatives now?	["Nancy Pelosi"]
who is the mother of prince michael jackson?	["Katherine Jackson","Joseph Jackson"]
who is the newly elected governor of california?	["Jerry Brown"]
who is the next governor of indiana?	["Mitch Daniels"]
who is the president of costa rica in 2012?	["Laura Chinchilla"]
who is the president of peru now?	["Ollanta Humala"]
who is the president of the european union 2012?	["Jerzy Buzek"]
who is the prime minister of jamaica west indies?	["Portia Simpson-Miller"]
who is the prime minister of spain 2011?	["Mariano Rajoy"]
who is the senior senator of louisiana?	["Mary Landrieu"]
who is the state governor of florida?	["Rick Scott"]
who is the state governor of tennessee?	["Bill Haslam"]
who is the texas state senator?	["Kay Bailey Hutchison"]
who is the voice of eric cartman on south park?	["Trey Parker"]
who is the voice of kitt?	["Val Kilmer"]
who is the woman that john edwards had an affair with?	["Rielle Hunter"]
who is thor heyerdahl?	["Film Director","Scientist","Cinematographer","Actor","Film Producer"]
who is vancouver canucks coach?	["Alain Vigneault"]
who is washington redskins backup qb?	["Rex Grossman"]
who is willow smith mom name?	["Jada Pinkett Smith"]
who killed lee harvey oswald shot?	["Jack Ruby"]
who killed martin luther king jr video?	["Assassination by firearm"]
who led the campaign in the shenandoah valley?	["Jackson's Valley Campaign"]
who led the mexican army at the battle of the alamo?	["Joaquín Amaro"]
who made the laws in canada?	["Supreme Court of Canada","Federal Court of Canada"]
who makes the voice of stewie griffin?	["Seth MacFarlane"]
who originally voiced lois griffin?	["Alex Borstein"]
who originally voiced meg on family guy?	["Mila Kunis"]
who or what influenced albert einstein?	["Hendrik Lorentz","Isaac Newton","Baruch Spinoza","George Bernard Shaw","Hermann Minkowski","James Clerk Maxwell","Paul Valéry","Karl Pearson","Ernst Mach","Bernhard Riemann"]
who or what influenced frank lloyd wright?	["Louis Sullivan","Bruce Price","Henry David Thoreau","Ebenezer Howard","William Morris","G. I. Gurdjieff","Elizabeth Gordon"]
who owns chrysler corporation 2011?	["Chrysler Group LLC"]
who owns google 2012?	["Larry Page","Sergey Brin"]
who owns mazda canada?	["Ford Motor Company"]
who owns the portland press herald?	["Blethen Maine Newspapers, Inc."]
who owns volkswagen car company?	["Volkswagen Group"]
who played alf on tv show?	["Paul Fusco"]
who played amy squirrel in bad teacher?	["Lucy Punch"]
who played barbara gordon batgirl?	["Alicia Silverstone"]
who played berger in sex and the city?	["for amos"]
who played bilbo in lord of the rings?	["Norman Bird","Martin Freeman","Ian Holm"]
who played bilbo in the fellowship of the ring?	["Ian Holm"]
who played captain kirk in star trek movie?	["William Shatner"]
who played carlton lassiter on psych?	["Timothy Omundson"]
who played carmen cortez in spy kids?	["Alexa Vega"]
who played cletus hogg?	["Jack Polick"]
who played damien in the omen 2006?	["Harvey Stephens","Tomas Wooler","Jonathan Scott-Taylor","Sam Neill","Seamus Davey-Fitzpatrick"]
who played dana scully in x files?	["Gillian Anderson"]
who played darth vader at the end of return of the jedi?	["James Earl Jones"]
who played darth vader in the first movie?	["David Prowse"]
who played denver in four christmases?	["William E. Adams","James Buck","George V. Kelley","Maximo Yabes","Debbie","Barbara Katie Chapman","Zebediah Duane Chapman"]
who played donna on west wing?	["Catherine Tate"]
who played elaine the pain?	["Julia Louis-Dreyfus"]
who played harry potter dumbledore actor?	["Dane Farwell"]
who played jacob black in twilight?	["Taylor Lautner"]
who played jeannie?	["Barbara Eden"]
who played kirk?	["Jimmy Bennett","Chris Pine","William Shatner"]
who played lauren reed on alias?	["Melissa George"]
who played maggie in himym?	["Nancy Cartwright"]
who played meg in season 1 of family guy?	["Lacey Chabert"]
who played mickey in the rocky movies?	["Wayne Allwine"]
who played obi wan in episode 2?	["Ewan McGregor"]
who played on the jeffersons?	["Isabel Sanford","Marla Gibbs","Sherman Hemsley"]
who played samantha stephens in bewitched?	["Elizabeth Montgomery"]
who played stanley kowalski in a streetcar named desire movie?	["Marlon Brando"]
who played victoria barkley?	["Barbara Stanwyck"]
who plays anakin skywalker in star wars 1?	["Jake Lloyd"]
who plays bilbo baggins in the hobbit?	["Norman Bird","Martin Freeman","Ian Holm"]
who plays billy elliot?	["Jamie Bell"]
who plays blaine in batman?	["Him/Herself"]
who plays bob kelso in scrubs?	["Ken Jenkins"]
who plays caesar flickerman in the hunger games?	["Art Conforti","Karl Draconis","Frank Mirelli","Richard Cross","Assemblyman Phillip Wingate","Arthur Scolari","Zack Lowman","Steven Demarco","Rick Pinzolo","Frank Mosca"]
who plays captain kirk in star trek?	["William Shatner"]
who plays charlie in the santa clause movies?	["Kansas City Athletics"]
who plays chuck bass in gossip girl?	["Ed Westwick"]
who plays donna noble?	["Catherine Tate"]
who plays dwight in the office?	["Rainn Wilson"]
who plays edward on deception?	["Robert Pattinson"]
who plays edward scissorhands?	["Johnny Depp"]
who plays elena gilbert on vampire diaries?	["Nina Dobrev"]
who plays eowyn in lord of the rings?	["Miranda Otto"]
who plays harley quinn?	["Arleen Sorkin","Mia Sara","Hynden Walch"]
who plays john connor?	["Edward Furlong","Christian Bale","Nick Stahl"]
who plays juni cortez?	["Daryl Sabara"]
who plays ken barlow in coronation street?	["Tony Warren"]
who plays kenneth?	["Jack McBrayer"]
who plays king julian madagascar?	["Sacha Baron Cohen"]
who plays knox overstreet?	["Josh Charles"]
who plays lex luthor on smallville?	["Michael Rosenbaum"]
who plays london tipton in suite life on deck?	["Brenda Song"]
who plays marshall eriksen?	["Jason Segel"]
who plays mary jane in the spiderman movies?	["Sara Ballantine","Kirsten Dunst"]
who plays nicholas newman on the young and the restless?	["Joshua Morrow"]
who plays ponyboy in that was then this is now?	["Pony Boy"]
who plays riley on buffy the vampire slayer?	["Marc Blucas"]
who plays robin hood in prince of thieves?	["Kevin Costner"]
who plays roxanne in ghost rider?	["Daryl Hannah"]
who plays sheldon cooper mother on the big bang theory?	["Jim Parsons"]
who plays simon birch?	["Ian Michael Smith"]
who plays spike spiegel?	["Steven Blum","Koichi Yamadera"]
who plays stacey in the stacy's mom video?	["Lacey Turner"]
who plays stanley hudson?	["Leslie David Baker"]
who plays stephanie plum in one for the money?	["Katherine Heigl"]
who plays the role of tony dinozzo on ncis?	["Michael Weatherly"]
who plays the voice of brian on family guy?	["Seth MacFarlane"]
who plays the voice of kitt in knight rider?	["William Daniels"]
who plays timon's voice in the lion king?	["Nathan Lane"]
who plays voldemort?	["Richard Bremmer","Frank Dillane","Ralph Fiennes","Hero Fiennes-Tiffin","Christian Coulson"]
who plays ziva david on ncis?	["Cote de Pablo"]
who ran against abraham lincoln for president in 1860?	["Stephen A. Douglas"]
who ran against bill clinton in the presidential election?	["George Bush"]
who ruled after king henry viii died?	["Edward VI of England"]
who rules denmark right now?	["Helle Thorning-Schmidt"]
who's dating claire danes?	["Hugh Dancy"]
who should the minnesota vikings draft?	["Harrison Smith","Devin Aromashodu","Chris Kluwe","Joe Webb","Christian Ponder","Josh Robinson","Jarius Wright","McLeod Bethel-Thompson","Blair Walsh","Stephen Burton"]
who voiced darth vader in the original star wars movies?	["James Earl Jones"]
who voiced darth vader?	["James Earl Jones"]
who was anakin skywalker?	["Darth Vader"]
who was canadian prime minister in 1993?	["Brian Mulroney"]
who was carolus linnaeus?	["Botanist"]
who was dan white?	["Firefighter","Politician","Police officer"]
who was demi lovato dating?	["Joe Jonas"]
who was esther's husband?	["Susa"]
who was france allied with in ww2?	["Allies of World War II"]
who was frida kahlo influenced by?	["Diego Rivera"]
who was gerald ford vp?	["Nelson Rockefeller"]
who was in the israeli palestinian conflict?	["Israel","Palestinian people"]
who was isaac newton and what did he do?	["Mathematician","Physicist","Philosopher","Astronomer","Scientist","Chemist"]
who was jesse james killed by?	["The Assassination of Jesse James by the Coward Robert Ford"]
who was jessica simpson married too?	["Nick Lachey"]
who was john f kennedy's family?	["John F. Kennedy, Jr.","Patrick Bouvier Kennedy","Arabella Kennedy","Caroline Kennedy"]
who was juan ponce de leon family?	["Leonor de Guzmán de Silva","Juan Ponce de León, II conde de Arcos"]
who was judi dench married to?	["Michael Williams"]
who was kate chopin?	["Writer"]
who was king after leonidas died?	["Pleistarchus"]
who was king george vi married to?	["Queen Elizabeth The Queen Mother"]
who was king henry viii son?	["Prince Henry, Duke of Cornwall","Edward VI of England","Mary I of England","Edward Tudor","Henry, Duke of Cornwall","Elizabeth I of England","Henry FitzRoy, 1st Duke of Richmond and Somerset","Henry Tudor"]
who was kobe bryant drafted by?	["Los Angeles Lakers"]
who was married to jane wyman?	["Bing Crosby & Jane Wyman"]
who was philip in acts chapter 8?	["Apostle Philip"]
who was president after franklin d. roosevelt?	["Harry S. Truman"]
who was president after william henry harrison?	["John Tyler"]
who was president in 1988 in the united states?	["Ronald Reagan"]
who was ptolemy and what did he do?	["Mathematician","Astronomer","Astrologer","Geographer","Philosopher"]
who was queen elizabeth ii mom?	["Queen Elizabeth The Queen Mother"]
who was queen isabella's mother?	["Maria of Aragon, Queen of Portugal"]
who was queen victoria's husband?	["Albert, Prince Consort"]
who was richard nixon married to?	["Pat Nixon"]
who was saint paul the apostle?	["Tentmaker","Prophet","Writer","Missionary","Martyr"]
who was selena gomez in barney and friends?	["Gianna"]
who was sir walter raleigh and what did he do?	["Poet","Courtier","Sailor","Writer","Soldier"]
who was stephen r covey?	["Management","Author","Consultant","Professor","Writer","Motivational speaking"]
who was the artist of mickey mouse?	["Ub Iwerks","Walt Disney"]
who was the father of king george vi?	["George V"]
who was the first dictator of the soviet union?	["Joseph Stalin"]
who was the first governor of colonial south carolina?	["Thomas Pinckney"]
who was the first president of the afl?	["Bud Adams","Lamar Hunt"]
who was the italian leader in ww1?	["Benito Mussolini"]
who was the leader of soviet union during wwii?	["Joseph Stalin"]
who was the leader of the first communist party of china?	["Chen Duxiu"]
who was the leader of the us during wwii?	["Gerald Ford"]
who was the original voice of meg griffin on family guy?	["Lacey Chabert"]
who was the prime minister of pakistan in 1999?	["Nawaz Sharif"]
who was the secretary of state when andrew jackson was president?	["Martin Van Buren"]
who was the son of king leonidas?	["Pleistarchus"]
who was the soviet leader during world war ii?	["Alexei Negmatov"]
who was the vice president under ronald reagan?	["George H. W. Bush"]
who was the voice of darth vader in the original star wars movie?	["James Earl Jones"]
who was tupac signed to?	["Death Row Records","Amaru Entertainment","Interscope Records"]
who was ulysses s. grant?	["Lieutenant-General"]
who was vice president after kennedy died?	["Lyndon B. Johnson"]
who was vice president when jfk was president?	["Lyndon B. Johnson"]
who was vice president with bill clinton?	["Al Gore"]
who was vp for lincoln?	["Andrew Johnson","Hannibal Hamlin"]
who was vp for nixon?	["Spiro Agnew","Gerald Ford"]
who was wesley snipes?	["Film Producer","Martial artist","Actor"]
who was william mckinley married to?	["Ida Saxton McKinley"]
who was with president lincoln when he was assassinated?	["Ford's Theatre"]
who were alexander graham bell's siblings?	["Chichester Bell","Melville James Bell"]
who were demeter's siblings?	["Zeus"]
who were jesus siblings?	["Jude the Apostle","James the Just","Simon (brother of Jesus)","Joses"]
who were king henry vii children?	["Arthur, Prince of Wales","Margaret Tudor","Mary Tudor, Queen of France","Henry VIII of England","Edward Tudor","Katherine Tudor","Edmund Tudor, Duke of Somerset","Elizabeth Tudor"]
who were mary shelley?	["Author"]
who were the children of king solomon?	["Absalom","Nathan","Adonijah"]
who were we fighting in the gulf war?	["Iraq"]
who were wright brothers?	["Orville Wright","Wilbur Wright"]
who will be the red sox next coach?	["Nomar Garciaparra"]
who will coach carolina panthers in 2013?	["Ron Rivera"]
who will plaxico burress play for in 2011?	["New York Jets"]
who will play mr gray in the film?	["Karen Mulder"]
who will the cavaliers draft 2012?	["Dion Waiters"]
who won fa cup 1976?	["Manchester United F.C."]
who won fedex cup 2012?	["Brandt Snedeker"]
who won the 2000 fa cup final?	["Liverpool F.C."]
who won the american league east in 2012?	["New York Yankees"]
who won the battle of gettysburg union or confederate?	["Union"]
who won the battle of gettysburg?	["United States of America"]
who won the governor election in texas?	["Rick Perry"]
who won the league cup in 2002?	["Liverpool F.C."]
who won the michigan ohio state game 2012?	["Ohio State Buckeyes football"]
who won the presidential election in egypt 2012?	["Hosni Mubarak"]
who won utah attorney general?	["Mark Shurtleff"]
who would play luke skywalker?	["Mark Hamill"]
who wrote st trinians?	["Ronald Searle"]
who wrote the gospel according to john?	["John the Evangelist"]
who wrote the jana gana mana?	["Ram Singh Thakur","Rabindranath Tagore"]
with which ancient ruler did julius caesar fall in love?	["Cornelia Cinna minor","Pompeia","Calpurnia Pisonis"]
